阿尔法罗米欧	汽车
阿斯顿马丁	汽车
广汽传祺	汽车
爱迪尔	汽车
安凯客车	汽车
奥德赛	汽车
奥迪	汽车
奥克斯	汽车
宝马	汽车
保时捷	汽车
北京奔驰	汽车
北京戴克	汽车
北京吉普	汽车
北京克莱斯勒	汽车
北京三菱	汽车
北京现代	汽车
北旅	汽车
北汽	汽车
北汽福田	汽车
奔驰	汽车
本田	汽车
比亚迪	汽车
标致	汽车
别克	汽车
宾利	汽车
铂锐	汽车
布加迪	汽车
长安福特	汽车
长安铃木	汽车
长安马自达	汽车
长安汽车	汽车
长城汽车	汽车
长丰猎豹	汽车
长丰三菱	汽车
昌河海豚	汽车
昌河骏马	汽车
昌河铃木	汽车
昌河汽车	汽车
重庆五十铃	汽车
大迪汽车	汽车
大发	汽车
大宇	汽车
大众	汽车
道奇	汽车
东风本田	汽车
东风标致	汽车
东风汽车	汽车
东风日产	汽车
东风雪铁龙	汽车
东风悦达起亚	汽车
东南道奇	汽车
东南克莱斯勒	汽车
东南汽车	汽车
东南三菱	汽车
法拉利	汽车
飞碟汽车	汽车
飞度	汽车
菲亚特	汽车
风景爱尔法	汽车
丰田	汽车
风行汽车	汽车
富迪汽车	汽车
福克斯	汽车
福莱尔	汽车
福美来	汽车
富奇	汽车
福瑞达	汽车
福特	汽车
福田传奇	汽车
广汽	汽车
广州宝龙	汽车
广州本田	汽车
广州丰田	汽车
广州五十铃	汽车
哈飞汽车	汽车
海福星	汽车
海马汽车	汽车
汉兰达	汽车
悍马	汽车
豪华轿车	汽车
黑豹汽车	汽车
红旗	汽车
华北	汽车
华晨宝马	汽车
华普	汽车
华泰	汽车
华阳汽车	汽车
皇冠锐志	汽车
汇众	汽车
吉奥	汽车
吉利	汽车
吉利熊猫	汽车
吉普	汽车
佳美	汽车
江淮	汽车
江铃	汽车
江南	汽车
捷豹	汽车
金杯	汽车
金程	汽车
金旅客车	汽车
京通客车	汽车
卡罗拉	汽车
凯迪拉克	汽车
凯美瑞	汽车
克莱斯勒	汽车
酷路泽	汽车
兰博基尼	汽车
蓝旗亚	汽车
朗杰	汽车
朗逸	汽车
劳斯莱斯	汽车
乐驰	汽车
雷驰	汽车
雷克萨斯	汽车
雷诺	汽车
力帆	汽车
莲花	汽车
猎豹飞腾	汽车
林肯	汽车
铃木	汽车
陆霸	汽车
陆风汽车	汽车
路虎	汽车
陆铃	汽车
罗孚	汽车
旅行家	汽车
马蒂兹	汽车
玛莎拉蒂	汽车
马自达	汽车
迈巴赫	汽车
美亚	汽车
蒙迪欧	汽车
蒙迪欧致胜	汽车
蒙派克	汽车
迷你	汽车
名爵	汽车
摩根	汽车
南京菲亚特	汽车
南汽	汽车
欧宝	汽车
讴歌	汽车
欧蓝德	汽车
帕杰罗	汽车
帕萨特	汽车
庞蒂克	汽车
普力马	汽车
骐达	汽车
骐菱	汽车
奇瑞	汽车
起亚	汽车
庆铃	汽车
青年莲花	汽车
全时数字轿车	汽车
日产	汽车
荣威	汽车
萨博	汽车
三菱	汽车
三菱戈蓝	汽车
桑塔纳志俊	汽车
陕西汽车	汽车
上海大众	汽车
上海大众斯柯达	汽车
上汽赛宝	汽车
申龙客车	汽车
世爵	汽车
曙光汽车	汽车
双环汽车	汽车
双龙	汽车
水星	汽车
斯巴鲁	汽车
思迪	汽车
斯柯达	汽车
思域	汽车
速威	汽车
苏州金龙	汽车
索纳塔	汽车
索纳塔御翔	汽车
天津一汽	汽车
天籁	汽车
天马汽车	汽车
通田	汽车
万丰汽车	汽车
威驰	汽车
沃尔沃	汽车
五菱	汽车
五十铃	汽车
厦门金龙	汽车
现代	汽车
逍客	汽车
新凯	汽车
雪佛兰	汽车
雪佛兰乐驰	汽车
雪铁龙	汽车
雅阁	汽车
雅力士	汽车
雅绅特	汽车
亚星客车	汽车
扬子汽车	汽车
颐达	汽车
伊兰特	汽车
伊兰特悦动	汽车
一汽奥迪	汽车
一汽奔腾	汽车
一汽大发	汽车
一汽大众	汽车
一汽丰田	汽车
一汽红塔	汽车
一汽佳宝	汽车
一汽解放	汽车
一汽马自达	汽车
一汽太湖	汽车
一拖	汽车
依维柯	汽车
英菲尼迪	汽车
宇通客车	汽车
原动力	汽车
悦动	汽车
跃进	汽车
云雀	汽车
郑州日产	汽车
中华	汽车
中顺	汽车
众泰	汽车
中通客车	汽车
中兴汽车	汽车
中誉客车	汽车
传祺	汽车
AL8	汽车
唐二代	汽车
卡宴	汽车
牧神记	 小说
钟馗捉妖记	 小说
择天记	 小说
万域之王	 小说
我是至尊	 小说
混沌剑神	 小说
神印王座	 小说
埃及艳后	 小说
白鹿原	 小说
西游记	 小说
红楼梦	 小说
水浒传	 小说
三国演义	 小说
了不起的盖茨比	 小说
长恨歌	 小说
平凡的世界	 小说
肖申克的救赎	 小说
诗经	 小说
钢铁是怎样炼成的	 小说
隋唐演义	 小说
变形记	 小说
红高粱	 小说
聊斋志异	 小说
围城	 小说
悲惨世界	 小说
茶馆	 小说
边城	 小说
老人与海	 小说
哈姆雷特	 小说
巴黎圣母院	 小说
城南旧事	 小说
呼啸山庄	 小说
安徒生童话	 小说
牡丹亭	 小说
封神演义	 小说
浮士德	 小说
战争与和平	 小说
红与黑	 小说
西厢记	 小说
世说新语	 小说
名人传	 小说
窦娥冤	 小说
双城记	 小说
倾城之恋	 小说
京华烟云	 小说
山楂树之恋	 小说
麦田里的守望者	 小说
儒林外史	 小说
四世同堂	 小说
雾都孤儿	 小说
堂吉诃德	 小说
斗罗大陆	 小说
白鹿原	 小说
三体	 小说
中国	地理
俄罗斯	地理
美国	地理
英国	地理
英格兰	地理
法国	地理
法兰西	地理
德国	地理
意大利	地理
比利时	地理
奥地利	地理
乌克兰	地理
以色列	地理
土耳其	地理
日本	地理
韩国	地理
越南	地理
泰国	地理
缅甸	地理
新加坡	地理
马来西亚	地理
菲律宾	地理
台湾	地理
台北	地理
湾湾	地理
大陆	地理
香港	地理
澳门	地理
深圳	地理
广州	地理
海南	地理
三亚	地理
重庆	地理
成都	地理
武汉	地理
大亚湾	地理
钓鱼岛	地理
美济礁	地理
南沙群岛	地理
西沙群岛	地理
黄岩岛	地理
南海	地理
新西兰	地理
澳洲	地理
澳大利亚	地理
悉尼	地理
大堡礁	地理
加州	地理
加利福尼亚	地理
加里宁格勒	地理
莫斯科	地理
华盛顿	地理
纽约	地理
费城	地理
肯尼迪	地理
墨西哥	地理
巴拿马	地理
海地	地理
尼日利亚	地理
欧洲	地理
非洲	地理
亚洲	地理
西班牙	地理
摩纳哥	地理
马耳他	地理
西西里	地理
罗马	地理
巴黎	地理
伦敦	地理
慕尼黑	地理
柏林	地理
都柏林	地理
苏格兰	地理
威尔士	地理
爱尔兰	地理
芝加哥	地理
底特律	地理
北京	地理
上海	地理
雄安	地理
北上广	地理
太平洋	地理
印度洋	地理
大西洋	地理
北冰洋	地理
北美	地理
加拿大	地理
多伦多	地理
瑞士	地理
比利时	地理
希腊	地理
雅典	地理
斯巴达	地理
埃及	地理
南非	地理
巴尔斯坦	地理
巴铁	地理
巴基斯坦	地理
蒙古	地理
中东	地理
黎巴嫩	地理
巴厘岛	旅游
夏威夷	旅游
关岛	地理
大阪	地理
东京	地理
仁川	地理
平壤	地理
朝鲜	地理
朝韩	地理
釜山	地理
首尔	地理
名古屋	旅游
济州岛	地理
梵蒂冈	地理
西藏	旅游
拉萨	旅游
叙利亚	地理
伊朗	地理
伊拉克	地理
巴格达	地理
也门	地理
红海	地理
黑海	地理
南极	地理
北极	地理
极地	地理
沙特阿拉伯	地理
陈瑶	 人物
韩庚	 人物
陈坤	 人物
李治廷	 人物
杨旭文	 人物
韩东君	 人物
鹿晗	 人物
迪丽热巴	 人物
赵丽颖	 人物
林允儿	 人物
胡冰卿	 人物
黎明	 人物
胡因梦	 人物
易烊千玺	 人物
黄子韬	 人物
新垣结衣	 人物
于毅	 人物
窦骁	 人物
杨幂	 人物
周杰伦	 人物
王俊凯	 人物
关晓彤	 人物
胡歌	 人物
彭丽媛	 人物
张艺兴	 人物
柴静	 人物
朱亚文	 人物
韩雪	 人物
李小龙	 人物
白岩松	 人物
李小冉	 人物
何炅	 人物
张嘉译	 人物
谢娜	 人物
吴宗宪	 人物
惠若琪	 人物
王小丫	 人物
吴昕	 人物
范丞丞	 人物
谢楠	 人物
沈梦辰	 人物
李连杰	 人物
撒贝宁	 人物
刘强东	 人物
王菲	 人物
朱一龙	 人物
成龙	 人物
古天乐	 人物
罗永浩	 人物
阿黛尔	 人物
彭丽媛	 人物
霍金	 人物
宫崎骏	 人物
李玫瑾	 人物
柴静	 人物
李小龙	 人物
东野圭吾	 人物
杨振宁	 人物
金庸	 人物
李敖	 人物
陈文茜	 人物
罗永浩	 人物
冯小刚	 人物
蒋方舟	 人物
莫言	 人物
张艺谋	 人物
方舟子	 人物
袁腾飞	 人物
张爱玲	 人物
时寒冰	 人物
王朔	 人物
三毛	 人物
袁隆平	 人物
老舍	 人物
王中磊	 人物
村上春树	 人物
刘震云	 人物
王小波	 人物
钱学森	 人物
王中军	 人物
林夕	 人物
单田芳	 人物
郭敬明	 人物
倪萍	 人物
刘慈欣	 人物
安意如	 人物
杨绛	 人物
韩寒	 人物
贾平凹	 人物
马未都	 人物
李壮平	 人物
陈丹青	 人物
李安	 人物
马光远	 人物
朱自清	 人物
曾仕强	 人物
俞敏洪	 人物
久石让	 人物
易中天	 人物
古龙	 人物
韩庚	 人物
陈坤	 人物
姚明	 人物
白岩松	 人物
范丞丞	 人物
李连杰	 人物
王菲	 人物
成龙	 人物
古天乐	 人物
高圆圆	 人物
黄晓明	 人物
崔永元	 人物
angelababy	 人物
马伊琍	 人物
黄明昊	 人物
李冰冰	 人物
赵本山	 人物
乌兰图雅	 人物
周笔畅	 人物
李亚鹏	 人物
佟大为	 人物
张曼玉	 人物
韩红	 人物
姚晨	 人物
史玉柱	 人物
杨澜	 人物
张梓琳	 人物
李晟	 人物
毕雯珺	 人物
范玮琪	 人物
刘璇	 人物
陈光标	 人物
苏芒	 人物
曹德旺	 人物
郑渊洁	 人物
李琳	 人物
丁泽仁	 人物
李权哲	 人物
白方礼	 人物
任志强	 人物
王卫	 人物
潘石屹	 人物
许家印	 人物
李书福	 人物
孙宏斌	 人物
王健林	 人物
王东明	 人物
董明珠	 人物
周凯旋	 人物
叶檀	 人物
索罗斯	 人物
向华强	 人物
郎咸平	 人物
王石	 人物
巴菲特	 人物
李大霄	 人物
杨惠妍	 人物
何超琼	 人物
孙正义	 人物
邓文迪	 人物
稻盛和夫	 人物
许世勋	 人物
马廷强	 人物
黄光裕	 人物
宗庆后	 人物
吴敬琏	 人物
陈光标	 人物
张近东	 人物
曹德旺	 人物
霍英东	 人物
邵逸夫	 人物
水皮	 人物
谢国忠	 人物
杨百万	 人物
王长田	 人物
黄仁勋	 人物
李颂慈	 人物
江南春	 人物
叶茂青	 人物
殷保华	 人物
冯仑	 人物
汤珈铖	 人物
王雅媛	 人物
陈志武	 人物
褚时健	 人物
梁稳根	 人物
杨受成	 人物
张五常	 人物
赵勇	 人物
梅西	 人物
c罗	 人物
詹姆斯	 人物
乔丹	 人物
费德勒	 人物
科比	 人物
姚明	 人物
惠若琪	 人物
欧文	 人物
李小鹏	 人物
巴特尔	 人物
内马尔	 人物
哈登	 人物
艾弗森	 人物
贝克汉姆	 人物
勒夫	 人物
罗纳尔多	 人物
穆勒	 人物
容国团	 人物
伊布	 人物
卡卡	 人物
克洛泽	 人物
罗伊斯	 人物
厄齐尔	 人物
卡恩	 人物
马拉多纳	 人物
阿扎尔	 人物
齐达内	 人物
格策	 人物
伊布拉希莫维奇	 人物
库蒂尼奥	 人物
罗纳尔迪尼奥	 人物
万大雪	 人物
诺伊尔	 人物
肖战	 人物
布冯	 人物
张本天杰	 人物
克罗斯	 人物
罗本	 人物
苏亚雷斯	 人物
托雷斯	 人物
小豌豆	 人物
郑大世	 人物
鲁尼	 人物
莱万多夫斯基	 人物
拉姆	 人物
范佩西	 人物
卡纳瓦罗	 人物
朴智星	 人物
埃尔南德斯	 人物
柴静	 人物
白岩松	 人物
何炅	 人物
谢娜	 人物
吴宗宪	 人物
王小丫	 人物
吴昕	 人物
谢楠	 人物
沈梦辰	 人物
撒贝宁	 人物
崔永元	 人物
王一博	 人物
黄健翔	 人物
沈星	 人物
沈冰	 人物
韩乔生	 人物
董卿	 人物
李梓萌	 人物
段暄	 人物
胡蝶	 人物
杨钰莹	 人物
张斌	 人物
周立波	 人物
窦文涛	 人物
李思思	 人物
倪萍	 人物
梁宏达	 人物
小s	 人物
刘建宏	 人物
董路	 人物
大鹏	 人物
俞灏明	 人物
孟非	 人物
毕福剑	 人物
周涛	 人物
杨澜	 人物
朱迅	 人物
马可	 人物
罗京	 人物
蔡康永	 人物
张泉灵	 人物
水均益	 人物
王宁	 人物
大冰	 人物
朱军	 人物
刘芳菲	 人物
汪涵	 人物
欧阳夏丹	 人物
朱丹	 人物
柯蓝	 人物
李白	 人物
朱德	 人物
林徽因	 人物
爱因斯坦	 人物
诸葛亮	 人物
鲁迅	 人物
李清照	 人物
林肯	 人物
雷锋	 人物
孔子	 人物
屈原	 人物
李隆基	 人物
苏轼	 人物
马克思	 人物
朱元璋	 人物
伍子胥	 人物
司马懿	 人物
武则天	 人物
太平公主	 人物
韩信	 人物
杜甫	 人物
妲己	 人物
秦始皇	 人物
拿破仑	 人物
成吉思汗	 人物
张学良	 人物
梵高	 人物
王阳明	 人物
雍正	 人物
贝多芬	 人物
项羽	 人物
达芬奇	 人物
刘备	 人物
汪精卫	 人物
康熙	 人物
白居易	 人物
慈禧	 人物
关羽	 人物
吕布	 人物
老子	 人物
赵云	 人物
陶渊明	 人物
溥仪	 人物
乾隆	 人物
列宁	 人物
曾国藩	 人物
辛弃疾	 人物
莎士比亚	 人物
杜月笙	 人物
孙中山	 人物
马云	 人物
刘强东	 人物
雷军	 人物
马化腾	 人物
乔布斯	 人物
任正非	 人物
李彦宏	 人物
罗永浩	 人物
贾跃亭	 人物
茅侃侃	 人物
张朝阳	 人物
比尔盖茨	 人物
史玉柱	 人物
孙亚芳	 人物
柳传志	 人物
李开复	 人物
扎克伯格	 人物
周鸿祎	 人物
丁磊	 人物
唐骏	 人物
张亚勤	 人物
陈天桥	 人物
王小川	 人物
沈南鹏	 人物
曹国伟	 人物
彭蕾	 人物
薛蛮子	 人物
李一男	 人物
方滨兴	 人物
陈瑶	 人物
迪丽热巴	 人物
赵丽颖	 人物
林允儿	 人物
胡冰卿	 人物
胡因梦	 人物
杨幂	 人物
关晓彤	 人物
彭丽媛	 人物
韩雪	 人物
李小冉	 人物
谢娜	 人物
王小丫	 人物
吴昕	 人物
谢楠	 人物
沈梦辰	 人物
王菲	 人物
阿黛尔	 人物
高圆圆	 人物
张天爱	 人物
宋祖儿	 人物
张歆艺	 人物
范冰冰	 人物
甘婷婷	 人物
吉克隽逸	 人物
卡罗琳	 人物
张韶涵	 人物
酒井法子	 人物
郑爽	 人物
唐嫣	 人物
叶子媚	 人物
欧阳娜娜	 人物
柳岩	 人物
裴涩琪	 人物
angelababy	 人物
刘语熙	 人物
古力娜扎	 人物
石原里美	 人物
张柏芝	 人物
邱淑贞	 人物
佟丽娅	 人物
刘亦菲	 人物
程潇	 人物
刘涛	 人物
张雪迎	 人物
万茜	 人物
李小璐	 人物
张子枫	 人物
周冬雨	 人物
周韵	 人物
韩庚	 人物
陈坤	 人物
李治廷	 人物
韩东君	 人物
鹿晗	 人物
黎明	 人物
易烊千玺	 人物
黄子韬	 人物
于毅	 人物
窦骁	 人物
周杰伦	 人物
王俊凯	 人物
胡歌	 人物
张艺兴	 人物
朱亚文	 人物
李小龙	 人物
张嘉译	 人物
吴宗宪	 人物
范丞丞	 人物
李连杰	 人物
朱一龙	 人物
成龙	 人物
古天乐	 人物
黄晓明	 人物
贝克汉姆	 人物
薛之谦	 人物
库蒂尼奥	 人物
周星驰	 人物
靳东	 人物
华晨宇	 人物
吴亦凡	 人物
李易峰	 人物
刘昊然	 人物
杨洋	 人物
林正英	 人物
张一山	 人物
tfboys	 人物
王源	 人物
罗晋	 人物
吴磊	 人物
刘德华	 人物
黄渤	 人物
邓超	 人物
陈赫	 人物
郭德纲	 人物
张国荣	 人物
姜文	 人物
林俊杰	 人物
张翰	 人物
王一博	 人物
梅西	 人物
詹姆斯	 人物
乔丹	 人物
费德勒	 人物
科比	 人物
欧文	 人物
哈登	 人物
韦德	 人物
阿黛尔	 人物
艾弗森	 人物
贝克汉姆	 人物
罗纳尔多	 人物
卡卡	 人物
齐达内	 人物
托雷斯	 人物
鲁尼	 人物
巴神	 人物
贾斯汀比伯	 人物
夏奇拉	 人物
杰森斯坦森	 人物
lady gaga	 人物
杜兰特	 人物
史泰龙	 人物
莱昂纳多	 人物
汤姆克鲁斯	 人物
蕾哈娜	 人物
斯嘉丽约翰逊	 人物
伊瓜因	 人物
巨石强森	 人物
比利亚	 人物
纳达尔	 人物
施瓦辛格	 人物
安妮海瑟薇	 人物
艾玛沃特森	 人物
尼古拉斯凯奇	 人物
奥尼尔	 人物
安吉丽娜朱莉	 人物
保罗	 人物
麦迪	 人物
艾薇儿	 人物
苏菲玛索	 人物
布兰妮	 人物
碧昂丝	 人物
安东尼	 人物
布拉德皮特	 人物
麦当娜	 人物
妮可基德曼	 人物
莫妮卡贝鲁奇	 人物
小罗伯特唐尼	 人物
罗斯	 人物
迈腾	 汽车
凯美瑞	 汽车
卡罗拉	 汽车
汉兰达	 汽车
雅阁	 汽车
蒙迪欧	 汽车
高尔夫	 汽车
哈弗h6	 汽车
速腾	 汽车
宝骏730	 汽车
五菱宏光	 汽车
君威	 汽车
帕萨特	 汽车
牧马人	 汽车
普拉多	 汽车
奥迪q5	 汽车
途观	 汽车
轩逸	 汽车
福克斯	 汽车
朗逸	 汽车
起亚k5	 汽车
宝马3系	 汽车
赛欧	 汽车
宝马5系	 汽车
奥迪a9	 汽车
英朗	 汽车
奔驰s级	 汽车
野马	 汽车
宝来	 汽车
捷达	 汽车
科鲁兹	 汽车
长安cs75	 汽车
凌渡	 汽车
桑塔纳	 汽车
翼虎	 汽车
凯越	 汽车
思铂睿	 汽车
现代ix35	 汽车
起亚k3	 汽车
起亚kx3	 汽车
起亚k4	 汽车
现代ix25	 汽车
众泰t600	 汽车
吉利熊猫	 汽车
奔奔	 汽车
奥拓	 汽车
北斗星	 汽车
爱迪尔	 汽车
宝马i3	 汽车
奔驰smart	 汽车
比亚迪f0	 汽车
福瑞达	 汽车
奇瑞qq	 汽车
mini	 汽车
雨燕	 汽车
威驰	 汽车
瑞纳	 汽车
polo	 汽车
赛欧	 汽车
飞度	 汽车
奥迪a1	 汽车
锋范	 汽车
起亚k2	 汽车
羚羊	 汽车
爱唯欧	 汽车
凯美瑞	 汽车
迈腾	 汽车
雅阁	 汽车
蒙迪欧	 汽车
君威	 汽车
帕萨特	 汽车
君越	 汽车
迈锐宝	 汽车
起亚k5	 汽车
宝马3系	 汽车
传祺ga6	 汽车
雷克萨斯es	 汽车
速派	 汽车
马自达6	 汽车
名图	 汽车
传祺	 汽车
思铂睿	 汽车
锐志	 汽车
蓝鸟	 汽车
红旗h7	 汽车
雪铁龙c5	 汽车
宝马m3	 汽车
英菲尼迪q50	 汽车
沃尔沃s60	 汽车
奔驰c级	 汽车
雷克萨斯is	 汽车
凯迪拉克ats	 汽车
沃尔沃s60l	 汽车
起亚k4	 汽车
红旗l5	 汽车
劳斯莱斯幻影	 汽车
林肯mkx	 汽车
辉腾	 汽车
起亚k9	 汽车
雷克萨斯ls	 汽车
宝马7系	 汽车
玛莎拉蒂总裁	 汽车
奥迪a9	 汽车
奔驰s级	 汽车
奥迪s8	 汽车
宝骏730	 汽车
夏朗	 汽车
五菱宏光	 汽车
比亚迪e6	 汽车
途安	 汽车
艾力绅	 汽车
上汽大通g10	 汽车
别克gl8	 汽车
奥德赛	 汽车
丰田埃尔法	 汽车
大众	 汽车
丰田	 汽车
本田	 汽车
奔驰	 汽车
宝马	 汽车
奥迪	 汽车
吉利	 汽车
日产	 汽车
别克	 汽车
福特	 汽车
奔腾	 汽车
奇瑞	 汽车
现代	 汽车
比亚迪	 汽车
雪佛兰	 汽车
起亚	 汽车
长安	 汽车
马自达	 汽车
宝骏	 汽车
哈弗	 汽车
沃尔沃	 汽车
jeep	 汽车
雷克萨斯	 汽车
铃木	 汽车
保时捷	 汽车
三菱	 汽车
北汽新能源	 汽车
凯迪拉克	 汽车
路虎	 汽车
五菱	 汽车
特斯拉	 汽车
广汽传祺	 汽车
一汽	 汽车
东风风神	 汽车
捷豹	 汽车
斯柯达	 汽车
江淮	 汽车
玛莎拉蒂	 汽车
荣威	 汽车
众泰	 汽车
标致	 汽车
红旗	 汽车
雪铁龙	 汽车
林肯	 汽车
兰博基尼	 汽车
知豆	 汽车
劳斯莱斯	 汽车
法拉利	 汽车
领克	 汽车
昌河	 汽车
习近平	政治
特朗普	政治
特没谱	政治
朴槿惠	政治
安培	政治
安培晋三	政治
文在寅	政治
蔡英文	政治
陈水扁	政治
李登辉	政治
李克强	政治
马英九	政治
三胖	政治
金三胖	政治
金日成	政治
金正日	政治
金正恩	政治
小英	政治
马克龙	政治
梅姨	政治
特蕾莎	政治
默克尔	政治
奥巴马	政治
克林顿	政治
小布什	政治
戈尔巴乔夫	政治
毛泽东	政治
邓小平	政治
杜特尔特	政治
联合国	政治
马丁路德金	政治
撒切尔	政治
丘吉尔	政治
罗斯福	政治
蒋介石	政治
蒋中正	政治
蒋经国	政治
经国先生	政治
蒋委员长	政治
习总书记	政治
周恩来	政治
周总理	政治
毛主席	政治
彭德怀	政治
彭老总	政治
马列毛邓	政治
马克思	政治
恩格斯	政治
列宁	政治
基辛格	政治
里根	政治
萨马兰奇	政治
二战	政治
抗日	政治
对越反击战	政治
对印反击战	政治
美帝	政治
上海合作组织	政治
上合组织	政治
北约	政治
北大西洋公约组织	政治
CIA	政治
FBI	政治
联邦调查局	政治
国安局	政治
NSA	政治
中情局	政治
军情处	政治
盟军	政治
协约国	政治
G20	政治
G7	政治
G8	政治
金砖国家	政治
欧派克	政治
东盟	政治
欧盟	政治
伊核问题	政治
朝核问题	政治
六方会谈	政治
自卫队	政治
辽宁号	政治
南海自由航行	政治
太平岛	政治
伊战	政治
两伊战争	政治
海湾战争	政治
海湾地区	政治
博鳌亚洲论坛	政治
博鳌论坛	政治
艾瑞克	电影
艾什莉	电影
埃文斯	电影
奥创	电影
奥创纪元	电影
奥克耶	电影
巴顿	电影
班纳	电影
鲍尔斯	电影
保罗	电影
贝坦尼	电影
变种人	电影
变种人兄弟会	电影
波蒂埃	电影
波兹	电影
布鲁斯	电影
布鲁斯班纳	电影
布思	电影
超胆侠	电影
超级英雄	电影
超音速移动	电影
惩罚者	电影
达米恩	电影
刀锋战士	电影
刀枪不入	电影
冬日战士	电影
恶灵骑士	电影
发射激光	电影
菲尔	电影
绯红女巫	电影
复仇者联盟	电影
弗瑞	电影
钢铁侠	电影
钢铁侠的女友	电影
钢铁侠女友	电影
钢铁侠战衣	电影
格雷格	电影
格鲁特	电影
格温妮丝	电影
海姆斯沃斯	电影
浩克	电影
黑豹	电影
黑寡妇	电影
红骷髅	电影
幻视	电影
幻视侠	电影
毁灭博士	电影
毁灭者德拉克斯	电影
混沌魔法	电影
火箭浣熊	电影
机械飞行翼	电影
贾维斯	电影
杰克逊	电影
杰瑞米	电影
杰瑞米雷纳	电影
惊奇女士	电影
卡魔拉	电影
科尔森	电影
克拉克	电影
克莱特巴顿	电影
克里斯	电影
克里斯埃文斯	电影
克里斯海姆斯沃斯	电影
克林特	电影
寇碧	电影
寇碧史莫德斯	电影
快银	电影
雷纳	电影
雷神	电影
雷神之锤	电影
利维坦	电影
猎鹰	电影
鲁法洛	电影
洛基	电影
洛基劳斐森	电影
罗杰斯	电影
罗曼诺夫	电影
绿巨人	电影
绿巨人浩克	电影
玛格达埃森哈特	电影
马克	电影
马克鲁弗洛	电影
玛丽亚	电影
满大人	电影
美国队长	电影
灭霸	电影
娜塔莎	电影
娜塔莎罗曼诺夫	电影
尼古拉斯约瑟夫弗瑞	电影
尼克	电影
尼克弗瑞	电影
帕特洛	电影
佩珀	电影
齐塔瑞人	电影
奇异博士	电影
塞缪尔	电影
塞缪尔杰克逊	电影
塞维格	电影
神盾局	电影
神盾局九级特工	电影
神盾局局长	电影
神盾局特工	电影
神奇四侠	电影
史蒂芬罗杰斯	电影
史莫德斯	电影
史塔克大楼	电影
斯蒂夫	电影
斯嘉丽	电影
斯嘉丽约翰逊	电影
斯卡斯加德	电影
斯塔克	电影
斯特兰	电影
苏里	电影
苏睿公主	电影
索尔奥丁森	电影
汤姆	电影
汤姆希德勒斯顿	电影
唐尼	电影
特工卡特	电影
托尔	电影
托尼	电影
托尼斯塔克	电影
无敌浩克	电影
无限战争	电影
希德勒斯顿	电影
希尔	电影
小辣椒	电影
小罗伯特	电影
小罗伯特唐尼	电影
邪神洛基	电影
邪神权杖	电影
星爵	电影
星云	电影
伊丽莎白奥尔森	电影
银河护卫队	电影
鹰眼	电影
宇宙立方	电影
宇宙魔方研究者	电影
约翰逊	电影
战争机器	电影
制造幻象	电影
蜘蛛侠	电影
狂暴巨兽	电影
头号玩家	电影
红海行动	电影
战狼2	电影
战狼	电影
极限挑战	电影
奔跑吧	电影
跑男	电影
向往的生活	电影
创造101	电影
极限男人帮	电影
极限三傻	电影
极限三精	电影
偶像练习生	电影
声临其境	电影
我想和你唱	电影
中国好声音	电影
中国新歌声	电影
我是歌手	电影
白子画	电影
班淑	电影
包拯	电影
必清	电影
陈长生	电影
楚乔	电影
道济	电影
狄仁杰	电影
尔康	电影
尔泰	电影
方世玉	电影
公孙策	电影
广亮	电影
郭靖	电影
花千骨	电影
花无缺	电影
黄蓉	电影
江小鱼	电影
姜子牙	电影
景天	电影
李马	电影
李未央	电影
白娘子	电影
法海	电影
李逍遥	电影
李修缘	电影
李寻欢	电影
李元芳	电影
芈月	电影
沙僧	电影
沈星移	电影
宋玉蝶	电影
苏妲己	电影
孙悟空	电影
唐三藏	电影
唐雪见	电影
铁心兰	电影
拓跋浚	电影
王宝钏	电影
卫青	电影
五阿哥	电影
吴聘	电影
小龙女	电影
小燕子	电影
徐有容	电影
薛平贵	电影
杨过	电影
易小川	电影
永琪	电影
玉漱	电影
宇文玥	电影
展昭	电影
赵灵儿	电影
赵子龙	电影
甄嬛	电影
周莹	电影
猪八戒	电影
紫薇	电影
白展堂	电影
同福客栈	电影
余则成	电影
沙溢	电影
哔哩哔哩	电影
葛平	电影
鬼畜区	电影
切格瓦拉	电影
诸葛村夫	电影
诸葛琴魔	电影
冰岛	 旅游
巴厘岛	 旅游
马尔代夫	 旅游
鼓浪屿	 旅游
普吉岛	 旅游
塞班岛	 旅游
长岛	 旅游
格陵兰岛	 旅游
夏威夷	 旅游
桃花岛	 旅游
北海道	 旅游
东极岛	 旅游
济州岛	 旅游
苏梅岛	 旅游
葫芦岛	 旅游
钓鱼岛	 旅游
北岛	 旅游
关岛	 旅游
崇明岛	 旅游
三沙市	 旅游
金银岛	 旅游
枸杞岛	 旅游
百慕大	 旅游
蜈支洲岛	 旅游
长滩岛	 旅游
开曼群岛	 旅游
南麂岛	 旅游
曹妃甸	 旅游
中途岛	 旅游
嵊泗列岛	 旅游
珍宝岛	 旅游
库页岛	 旅游
南澳岛	 旅游
永兴岛	 旅游
黄岩岛	 旅游
南沙群岛	 旅游
月坨岛	 旅游
外伶仃岛	 旅游
西沙群岛	 旅游
分界洲岛	 旅游
黑瞎子岛	 旅游
绿岛	 旅游
圣托里尼岛	 旅游
美济礁	 旅游
凤凰	 旅游
故宫博物馆	 旅游
九寨沟	 旅游
黄山	 旅游
华山	 旅游
乌镇	 旅游
颐和园	 旅游
泰山	 旅游
稻城亚丁	 旅游
香格里拉	 旅游
北戴河	 旅游
青海湖	 旅游
鼓浪屿	 旅游
八达岭长城	 旅游
都江堰	 旅游
圆明园	 旅游
千岛湖	 旅游
长白山	 旅游
五台山	 旅游
泸沽湖	 旅游
庐山	 旅游
井冈山	 旅游
武夷山	 旅游
洱海	 旅游
西湖	 旅游
东方明珠	 旅游
峨眉山	 旅游
莫高窟	 旅游
三峡	 旅游
普陀山	 旅游
乐山大佛	 旅游
布达拉宫	 旅游
景德镇	 旅游
三清山	 旅游
武当山	 旅游
黄果树瀑布	 旅游
苏州园林	 旅游
九华山	 旅游
神农架	 旅游
西塘	 旅游
秦始皇陵	 旅游
壶口瀑布	 旅游
三峡大坝	 旅游
冈仁波齐	 旅游
鸟巢	 旅游
太湖	 旅游
拙政园	 旅游
可可西里	 旅游
天坛	 旅游
周庄	 旅游
巴厘岛	 旅游
马尔代夫	 旅游
威尼斯	 旅游
普吉岛	 旅游
塞班岛	 旅游
毛里求斯	 旅游
夏威夷	 旅游
埃菲尔铁塔	 旅游
拉斯维加斯	 旅游
芭提雅	 旅游
圣托里尼	 旅游
卢浮宫	 旅游
苏梅岛	 旅游
吴哥窟	 旅游
比萨斜塔	 旅游
泰姬陵	 旅游
普罗旺斯	 旅游
凡尔赛宫	 旅游
悉尼歌剧院	 旅游
埃及金字塔	 旅游
好望角	 旅游
莱茵河	 旅游
多瑙河	 旅游
罗马斗兽场	 旅游
科罗拉多大峡谷	 旅游
塞纳河	 旅游
乌镇	 旅游
景德镇	 旅游
芙蓉镇	 旅游
西塘古镇	 旅游
南浔古镇	 旅游
青岩古镇	 旅游
周庄古镇	 旅游
黄姚古镇	 旅游
朱家角古镇	 旅游
洛带古镇	 旅游
柳江古镇	 旅游
iphone	 科技
小米手机	 科技
华为	 科技
努比亚	 科技
oppo	 科技
vivo	 科技
荣耀	 科技
三星	 科技
魅族	 科技
诺基亚	 科技
一加手机	 科技
锤子手机	 科技
摩托罗拉	 科技
金立	 科技
htc	 科技
中兴	 科技
联想	 科技
美图手机	 科技
黑莓	 科技
黑鲨手机	 科技
360	 科技
乐视手机	 科技
lg	 科技
索尼	 科技
华硕	 科技
酷派	 科技
e人e本	 科技
夏普	 科技
索尼爱立信	 科技
飞利浦	 科技
威图	 科技
zuk	 科技
谷歌	 科技
小辣椒手机	 科技
大神	 科技
朵唯	 科技
多普达	 科技
天语	 科技
海信	 科技
奇酷	 科技
微软	 科技
中国移动	 科技
sugar	 科技
koobee	 科技
ivvi	 科技
波导	 科技
中天	 科技
创维	 科技
长虹	 科技
乐讯	 科技
qq	 科技
微信	 科技
迅雷	 科技
qq音乐	 科技
qq影音	 科技
qq空间	 科技
qq阅读	 科技
驱动精灵	 科技
搜狗输入法	 科技
wps	 科技
鲁大师	 科技
bt	 科技
美图秀秀	 科技
酷狗	 科技
chrome	 科技
itunes	 科技
格式工厂	 科技
暴风影音	 科技
驱动人生	 科技
搜狗浏览器	 科技
pptv	 科技
winrar	 科技
阿里旺旺	 科技
按键精灵	 科技
360安全卫士	 科技
outlook	 科技
迅雷看看	 科技
会声会影	 科技
金山词霸	 科技
百度浏览器	 科技
金山毒霸	 科技
快播	 科技
光影魔术手	 科技
foxmail	 科技
firefox	 科技
office2010	 科技
matlab	 科技
迅游	 科技
虚拟光驱	 科技
猎豹浏览器	 科技
coreldraw	 科技
skype	 科技
酷我音乐盒	 科技
autocad	 科技
百度软件	 科技
directx	 科技
wifi万能钥匙	 科技
3dmax	 科技
windows7旗舰版	 科技
visual studio	 科技
premiere	 科技
金山打字通	 科技
ghost	 科技
微微一笑很倾城	 电视剧
凤囚凰	 电视剧
一路繁花相送	 电视剧
扶摇	 电视剧
水浒传	 电视剧
武林外传	 电视剧
同学两亿岁	 电视剧
校花的贴身高手	 电视剧
泡沫之夏	 电视剧
爱情公寓4	 电视剧
秦时明月	 电视剧
倚天屠龙记	 电视剧
爱情公寓3	 电视剧
灵魂摆渡	 电视剧
亮剑	 电视剧
鹿鼎记	 电视剧
人间正道是沧桑	 电视剧
花千骨	 电视剧
新三国演义	 电视剧
潜伏	 电视剧
旋风少女第二季	 电视剧
家有儿女	 电视剧
爱情公寓2	 电视剧
热血狂篮	 电视剧
绝命毒师	 电视剧
摩登家庭	 电视剧
我的团长我的团	 电视剧
来自星星的你	 电视剧
男人的天堂	 电视剧
毛骗	 电视剧
还珠格格	 电视剧
大秦帝国	 电视剧
杉杉来了	 电视剧
神雕侠侣古天乐版	 电视剧
汉武大帝	 电视剧
legal high	 电视剧
何以笙箫默	 电视剧
童话镇	 电视剧
命中注定我爱你	 电视剧
下一站幸福	 电视剧
克拉恋人	 电视剧
大时代	 电视剧
西游记后传	 电视剧
我爱我家	 电视剧
男人帮	 电视剧
回家的诱惑	 电视剧
银魂	 电视剧
逆水寒	 电视剧
微微一笑很倾城	 电视剧
红楼梦	 电视剧
一路繁花相送	 电视剧
水浒传	 电视剧
爱情公寓	 电视剧
匆匆那年	 电视剧
天涯明月刀	 电视剧
校花的贴身高手	 电视剧
我的前半生	 电视剧
雍正王朝	 电视剧
泡沫之夏	 电视剧
宫心计	 电视剧
金秘书为什么那样	 电视剧
康熙王朝	 电视剧
倚天屠龙记	 电视剧
新白娘子传奇	 电视剧
爱情公寓3	 电视剧
鹿鼎记	 电视剧
人间正道是沧桑	 电视剧
如果，爱	 电视剧
欢乐颂	 电视剧
花千骨	 电视剧
潜伏	 电视剧
旋风少女第二季	 电视剧
爱情公寓2	 电视剧
步步惊心	 电视剧
热血狂篮	 电视剧
封神榜	 电视剧
摩登家庭	 电视剧
来自星星的你	 电视剧
和平饭店	 电视剧
大宅门1912	 电视剧
游戏人生	 电视剧
毛骗	 电视剧
还珠格格	 电视剧
远大前程	 电视剧
杉杉来了	 电视剧
昼颜	 电视剧
李卫当官	 电视剧
死神来了	 电视剧
太子妃升职记	 电视剧
我和僵尸有个约会	 电视剧
神雕侠侣古天乐版	 电视剧
我的大叔	 电视剧
汉武大帝	 电视剧
legal high	 电视剧
红楼梦	 电视剧
凤囚凰	 电视剧
极品家丁	 电视剧
庆余年	 电视剧
水浒传	 电视剧
天涯明月刀	 电视剧
武林外传	 电视剧
甄嬛传	 电视剧
玄门大师	 电视剧
琅琊榜	 电视剧
雍正王朝	 电视剧
大主宰	 电视剧
仙剑奇侠传3	 电视剧
如懿传	 电视剧
莽荒纪	 电视剧
宫心计	 电视剧
秦时明月	 电视剧
康熙王朝	 电视剧
倚天屠龙记	 电视剧
新白娘子传奇	 电视剧
鹿鼎记	 电视剧
花千骨	 电视剧
古剑奇谭	 电视剧
新三国演义	 电视剧
大明王朝1566	 电视剧
天龙八部	 电视剧
天龙八部黄日华版	 电视剧
步步惊心	 电视剧
芈月传	 电视剧
铁齿铜牙纪晓岚	 电视剧
太古神王	 电视剧
曹操	 电视剧
少年包青天	 电视剧
神探狄仁杰	 电视剧
锦绣未央	 电视剧
还珠格格	 电视剧
花木兰传奇	 电视剧
大秦帝国	 电视剧
大军师司马懿之军师联盟	 电视剧
李卫当官	 电视剧
太子妃升职记	 电视剧
神雕侠侣古天乐版	 电视剧
楚汉传奇	 电视剧
汉武大帝	 电视剧
龙门镖局	 电视剧
宰相刘罗锅	 电视剧
大秦帝国之纵横	 电视剧
将军在上	 电视剧
成吉思汗	 电视剧
初婚	 电视剧
家有儿女初长成	 电视剧
泡沫之夏	 电视剧
父母爱情	 电视剧
家有儿女	 电视剧
摩登家庭	 电视剧
男人的天堂	 电视剧
大宅门1912	 电视剧
昼颜	 电视剧
搞笑一家人	 电视剧
金粉世家	 电视剧
风车	 电视剧
回家的诱惑	 电视剧
回家的路有多远	 电视剧
不能说的秘密	 电视剧
小丈夫	 电视剧
父爱如山	 电视剧
与青春有关的日子	 电视剧
金婚	 电视剧
蜗居	 电视剧
血色浪漫	 电视剧
你是我兄弟	 电视剧
樱桃	 电视剧
乔家大院	 电视剧
温柔的谎言	 电视剧
假如生活欺骗了你	 电视剧
离婚协议	 电视剧
上门女婿	 电视剧
风和日丽	 电视剧
马大帅	 电视剧
妻子的诱惑	 电视剧
海派甜心	 电视剧
大丈夫	 电视剧
甜蜜蜜	 电视剧
渴望	 电视剧
小爸爸	 电视剧
一仆二主	 电视剧
幸福照相馆	 电视剧
夏家三千金	 电视剧
三毛流浪记	 电视剧
家有儿女第二部	 电视剧
温柔的诱惑	 电视剧
裸婚时代	 电视剧
千山暮雪	 电视剧
东北一家人	 电视剧
半生缘	 电视剧
西部世界	 电视剧
破产姐妹	 电视剧
绝命毒师	 电视剧
神盾局特工	 电视剧
摩登家庭	 电视剧
闪电侠	 电视剧
冰与火之歌	 电视剧
纸牌屋	 电视剧
初代吸血鬼	 电视剧
老友记第一季	 电视剧
福尔摩斯：基本演绎法第一季	 电视剧
绿箭侠	 电视剧
周六夜现场	 电视剧
情妇	 电视剧
越狱第一季	 电视剧
汉尼拔	 电视剧
性爱大师	 电视剧
行尸走肉第三季	 电视剧
生活大爆炸第九季	 电视剧
斯巴达克斯第三季	 电视剧
蛇蝎美人第一季	 电视剧
遗失的世界	 电视剧
尼基塔第三季	 电视剧
越狱第二季	 电视剧
行尸走肉第四季	 电视剧
特工卡特	 电视剧
美国恐怖故事第二季	 电视剧
黑吃黑	 电视剧
加里森敢死队	 电视剧
塞尔福里奇先生	 电视剧
蛇蝎美人第二季	 电视剧
格林第一季	 电视剧
心理追凶	 电视剧
美国恐怖故事第三季	 电视剧
无耻家庭	 电视剧
妖女迷行	 电视剧
吸血鬼日记第一季	 电视剧
风中的女王	 电视剧
大器晚成	 电视剧
纸牌屋第二季	 电视剧
圣城风云	 电视剧
低俗怪谈	 电视剧
新闻编辑室	 电视剧
猎魔人	 电视剧
加州靡情	 电视剧
越狱第三季	 电视剧
血战太平洋	 电视剧
死亡谷	 电视剧
经常请吃饭的漂亮姐姐	 电视剧
来自星星的你	 电视剧
继承者们	 电视剧
我的大叔	 电视剧
鲨鱼	 电视剧
healer	 电视剧
秘密花园	 电视剧
匹诺曹	 电视剧
窈窕淑女	 电视剧
步步惊心：丽	 电视剧
听见你的声音	 电视剧
加油吧威基基	 电视剧
大长今	 电视剧
城市猎人	 电视剧
花样男子	 电视剧
主君的太阳	 电视剧
恋爱的发现	 电视剧
学校2015	 电视剧
求婚大作战	 电视剧
蓝色生死恋	 电视剧
妻子的诱惑	 电视剧
恶作剧之吻	 电视剧
请回答1994	 电视剧
拥抱太阳的月亮	 电视剧
豪杰春香	 电视剧
波塞冬	 电视剧
夜行书生	 电视剧
成均馆绯闻	 电视剧
澡堂老板家的男人们	 电视剧
人鱼小姐	 电视剧
请回答1997	 电视剧
我的女孩	 电视剧
别有用心的单身女	 电视剧
不汗党	 电视剧
红字	 电视剧
奇皇后	 电视剧
Doctor异乡人	 电视剧
一闪一闪亮晶晶	 电视剧
天国的阶梯	 电视剧
记忆	 电视剧
绅士的品格	 电视剧
追踪者	 电视剧
银魂	 电视剧
孤独的美食家	 电视剧
一吻定情	 电视剧
半泽直树	 电视剧
东京爱情故事	 电视剧
朝5晚9	 电视剧
神探伽利略	 电视剧
欺诈游戏	 电视剧
镜子超人	 电视剧
悠长假期	 电视剧
假面骑士空我	 电视剧
特搜战队刑事连者	 电视剧
天装战队护星者	 电视剧
一吻定情2	 电视剧
新宿天鹅	 电视剧
兽拳战队激气连者	 电视剧
超级银河大怪兽格斗	 电视剧
最完美的离婚	 电视剧
紧闭的门扉	 电视剧
下北阳光灿烂的日子	 电视剧
幻夜	 电视剧
在这世界的角落	 电视剧
黑色皮革手册	 电视剧
父女七日变	 电视剧
家政妇三田	 电视剧
上锁的房间	 电视剧
大和抚子	 电视剧
炎神战队轰音者	 电视剧
笃姬	 电视剧
怪谈百物语	 电视剧
真女神转生	 电视剧
新参者	 电视剧
甜心战士	 电视剧
流星之绊	 电视剧
毛骨悚然撞鬼经	 电视剧
排球女将	 电视剧
魔女的条件	 电视剧
新选组	 电视剧
平清盛	 电视剧
倒数第二次恋爱	 电视剧
小遥17岁	 电视剧
东野圭吾推理系列	 电视剧
娘王	 电视剧
诈欺游戏	 电视剧
欺诈猎人	 电视剧
野猪大改造	 电视剧
侍战队真剑者	 电视剧
世界奇妙物语	 电视剧
极道鲜师	 电视剧
宫心计	 电视剧
天龙八部黄日华版	 电视剧
金枝欲孽2	 电视剧
神雕侠侣古天乐版	 电视剧
还看今朝	 电视剧
使徒行者	 电视剧
功夫足球	 电视剧
圆月弯刀	 电视剧
龙的天空	 电视剧
读心神探	 电视剧
小鱼儿与花无缺	 电视剧
万凰之王	 电视剧
法证先锋3	 电视剧
万水千山总是情	 电视剧
太极张三丰	 电视剧
九五至尊	 电视剧
霍元甲	 电视剧
千王之王	 电视剧
天地争霸美猴王	 电视剧
法证先锋2	 电视剧
刑事侦缉档案3	 电视剧
学警狙击	 电视剧
千王之王重出江湖	 电视剧
楚汉骄雄	 电视剧
少年四大名捕	 电视剧
边城浪子	 电视剧
人龙传说	 电视剧
潜行狙击	 电视剧
溏心风暴	 电视剧
我和僵尸有个约会2	 电视剧
妙手仁心	 电视剧
古灵精探	 电视剧
冲上云霄2	 电视剧
谈情说案	 电视剧
陀枪师姐4	 电视剧
齐天大圣孙悟空	 电视剧
郑板桥	 电视剧
笑看风云	 电视剧
搜神传	 电视剧
僵尸道长1	 电视剧
刑事侦缉档案4	 电视剧
锦绣良缘	 电视剧
八仙过海	 电视剧
我和僵尸有个约会3	 电视剧
倚天屠龙记吴启华版	 电视剧
天地男儿	 电视剧
金装四大才子	 电视剧
迷离档案	 电视剧
刑事侦缉档案2	 电视剧
泡沫之夏	 电视剧
新白娘子传奇	 电视剧
下一站幸福	 电视剧
放羊的星星	 电视剧
王子变青蛙	 电视剧
小丈夫	 电视剧
终极三国	 电视剧
第八号当铺	 电视剧
公主小妹	 电视剧
海派甜心	 电视剧
我可能不会爱你	 电视剧
钟无艳	 电视剧
终极一家	 电视剧
戏说乾隆	 电视剧
萌学园	 电视剧
海豚湾恋人	 电视剧
流星花园2	 电视剧
绝代双骄	 电视剧
终极一班3	 电视剧
痞子英雄	 电视剧
天使之翼	 电视剧
原来是美男	 电视剧
绿光森林	 电视剧
家和万事兴	 电视剧
天国的嫁衣	 电视剧
昨夜星辰	 电视剧
倚天屠龙记马景涛版	 电视剧
哑巴新娘	 电视剧
梅花三弄	 电视剧
真爱趁现在	 电视剧
旋风管家	 电视剧
七侠五义	 电视剧
高塔公主	 电视剧
败犬女王	 电视剧
烟雨蒙蒙	 电视剧
两个爸爸	 电视剧
我爱美人鱼	 电视剧
转角遇到爱	 电视剧
婉君	 电视剧
天地传说之鱼美人	 电视剧
西门无恨	 电视剧
终极一班2	 电视剧
再见阿郎	 电视剧
1006的房客	 电视剧
唐太宗李世民	 电视剧
夜市人生	 电视剧
千金百分百	 电视剧
天下无双	 电视剧
怀玉公主	 电视剧
黑糖玛奇朵	 电视剧
浪漫满屋	 电视剧
一诺倾情	 电视剧
白莲花	 电视剧
离心	 电视剧
千方百计爱上你	 电视剧
心的唯一	 电视剧
爱的被告	 电视剧
偷心俏冤家	 电视剧
临时天堂	 电视剧
玻钻之争	 电视剧
花环夫人	 电视剧
爱的捆绑	 电视剧
焦糖	 电视剧
爱在日落之前	 电视剧
爱在旅途	 电视剧
情牵两世	 电视剧
黑色幽默	 电视剧
白鹿原	 电视剧
银魂	 电视剧
天黑请闭眼	 电视剧
烈火如歌	 电视剧
镇魂	 电视剧
逆水寒	 电视剧
微微一笑很倾城	 电视剧
红楼梦	 电视剧
神雕侠侣	 电视剧
凤囚凰	 电视剧
愤怒的小鸟	 电视剧
射雕英雄传	 电视剧
盗墓笔记	 电视剧
孤芳不自赏	 电视剧
鬼吹灯	 电视剧
台湾往事	 电视剧
极品家丁	 电视剧
庆余年	 电视剧
以你为名的青春	 电视剧
一路繁花相送	 电视剧
孔子	 电视剧
扶摇	 电视剧
平凡的世界	 电视剧
水浒传	 电视剧
宫心计2：深宫计	 电视剧
恋爱先生	 电视剧
扶摇皇后	 电视剧
屈原	 电视剧
爱情公寓	 电视剧
西部世界	 电视剧
法医秦明	 电视剧
匆匆那年	 电视剧
爱国者	 电视剧
天涯明月刀	 电视剧
东方华尔街	 电视剧
萌妃驾到	 电视剧
骨语	 电视剧
归去来	 电视剧
钟馗捉妖记	 电视剧
武林外传	 电视剧
甄嬛传	 电视剧
三生三世十里桃花	 电视剧
萌妻食神	 电视剧
玄门大师	 电视剧
同学两亿岁	 电视剧
校花的贴身高手	 电视剧
琅琊榜	 电视剧
詹姆斯	体育
邓肯	体育
詹皇	体育
梅西	体育
C罗	体育
刘翔	体育
科比	体育
安东尼	体育
李娜	体育
内马尔	体育
苏亚雷斯	体育
姚明	体育
邓亚萍	体育
马龙	体育
张继科	体育
罗德里格斯	体育
哈登	体育
马塞洛	体育
乔丹	体育
大卫路易斯	体育
贝克汉姆	体育
伊丽莎白	体育
卡西利亚斯	体育
孙杨	体育
格策	体育
李坚柔	体育
刘语熙	体育
纳达尔	体育
卡卡	体育
罗纳尔多	体育
哈维	体育
本泽马	体育
郜林	体育
里皮	体育
库里	体育
拉莫斯	体育
西甲	体育
德甲	体育
英超	体育
中超	体育
杰拉德	体育
宁泽涛	体育
田亮	体育
杨威	体育
克洛泽	体育
世界杯	体育
穆勒	体育
NBA	体育
太阳队	体育
纽约尼克斯	体育
曼联	体育
切尔西	体育
巴塞罗那	体育
巴萨	体育
皇马	体育
皇家马德里	体育
马刺	体育
热刺	体育
慕尼黑	体育
曼城	体育
利物浦	体育
林书豪	体育
罗本	体育
韦德	体育
鲁尼	体育
凯文杜兰特	体育
范佩西	体育
吴磊	体育
郑智	体育
郝海东	体育
范志毅	体育
李毅	体育
孙继海	体育
阿里扎	体育
杨晨	体育
巴洛特利	体育
穆里尼奥	体育
罗斯	体育
霍华德	体育
托雷斯	体育
诺伊尔	体育
冯珊珊	体育
林丹	体育
伊布	体育
厄齐尔	体育
中国队	体育
巴西队	体育
阿根廷队	体育
法国队	体育
美国队	体育
英格兰队	体育
比利时队	体育
德国队	体育
意大利队	体育
苏格兰队	体育
爱尔兰队	体育
荷兰队	体育
纳英戈兰	体育
贝尔	体育
火箭	体育
湖人	体育
马刺	体育
杜兰特	体育
艾弗森	体育
阿里纳斯	体育
国足	体育
西游记女儿国	 电影
蓝色金鱼	 电影
白鹿原	 电影
芳华	 电影
妖猫传	 电影
天生一对	 电影
霸王别姬	 电影
灵魂摆渡黄泉	 电影
台湾往事	 电影
无问西东	 电影
朗读者	 电影
血观音	 电影
美丽人生	 电影
致我们终将逝去的青春	 电影
傲慢与偏见	 电影
西西里的美丽传说	 电影
水形物语	 电影
白夜行	 电影
成吉思汗	 电影
哈尔的移动城堡	 电影
国产凌凌漆	 电影
海上钢琴师	 电影
灵契	 电影
婚前试爱	 电影
小情人	 电影
不能说的秘密	 电影
洛丽塔	 电影
烟花	 电影
阿飞正传	 电影
僵尸新娘	 电影
太阳照常升起	 电影
旺角卡门	 电影
一生所爱	 电影
赤裸特工	 电影
海阔天空	 电影
重庆森林	 电影
春娇与志明	 电影
放牛班的春天	 电影
艺伎回忆录	 电影
小时代	 电影
窈窕淑女	 电影
饮食男女	 电影
长发公主	 电影
剑雨	 电影
初恋这件小事	 电影
无法忍受	 电影
茜茜公主	 电影
情事	 电影
西游记女儿国	 电影
寻梦环游记	 电影
天生一对	 电影
羞羞的铁拳	 电影
缝纫机乐队	 电影
十二生肖	 电影
帕丁顿熊2	 电影
陈翔六点半之铁头无敌	 电影
超人总动员	 电影
起跑线	 电影
僵尸先生	 电影
魔方	 电影
少林足球	 电影
让子弹飞	 电影
熊出没之夺宝熊兵	 电影
捉妖记2	 电影
三傻大闹宝莱坞	 电影
我是你妈	 电影
赌神	 电影
疯狂的石头	 电影
尼斯湖水怪	 电影
杀人回忆	 电影
国产凌凌漆	 电影
唐伯虎点秋香	 电影
西游·降魔篇	 电影
小情人	 电影
七十二家房客	 电影
祖宗十九代	 电影
九品芝麻官	 电影
功夫厨神	 电影
春娇与志明	 电影
失落的大陆	 电影
无敌破坏王	 电影
赌侠	 电影
查理和巧克力工厂	 电影
食神	 电影
长发公主	 电影
史密斯夫妇	 电影
王牌特工2	 电影
初恋这件小事	 电影
魔幻时刻	 电影
机器人总动员	 电影
辛普森一家	 电影
回魂夜	 电影
千王之王2000	 电影
两只老虎	 电影
精灵旅社	 电影
人在囧途	 电影
龙的传人	 电影
复仇者联盟	 电影
古墓丽影	 电影
天黑请闭眼	 电影
骑士	 电影
终结者2	 电影
与神同行	 电影
生死狙击	 电影
红海行动	 电影
侏罗纪公园3	 电影
完美陌生人	 电影
寂静之地	 电影
闪灵	 电影
血观音	 电影
蚁人	 电影
这个杀手不太冷	 电影
忌日快乐	 电影
死神来了	 电影
林中小屋	 电影
电锯惊魂	 电影
水形物语	 电影
金刚狼	 电影
生化危机	 电影
七宗罪	 电影
沉默的羔羊	 电影
白夜行	 电影
孤岛惊魂	 电影
普罗米修斯	 电影
东方快车谋杀案	 电影
英雄无敌3	 电影
杀人回忆	 电影
古墓丽影2	 电影
超凡蜘蛛侠	 电影
机械师	 电影
午夜电影	 电影
恐怖游轮	 电影
v字仇杀队	 电影
钢铁侠2	 电影
火柴人	 电影
新僵尸先生	 电影
黑色大丽花	 电影
生化危机2	 电影
死寂	 电影
搏击俱乐部	 电影
银翼杀手2049	 电影
禁闭岛	 电影
十二猴子	 电影
两杆大烟枪	 电影
电锯惊魂8	 电影
汉江怪物	 电影
致命id	 电影
环太平洋：雷霆再起	 电影
复仇者联盟	 电影
钢铁侠3	 电影
星球大战8	 电影
三体	 电影
终结者2	 电影
x战警	 电影
人工智能	 电影
正义联盟	 电影
复仇者联盟3：无限战争	 电影
头号玩家	 电影
雷神	 电影
黑豹	 电影
侏罗纪公园3	 电影
阿凡达	 电影
复仇者联盟2：奥创纪元	 电影
美国队长	 电影
蚁人	 电影
阿凡达2	 电影
僵尸世界大战	 电影
勇敢者游戏：决战丛林	 电影
金刚狼	 电影
盗梦空间	 电影
绿巨人	 电影
普罗米修斯	 电影
移动迷宫3：死亡解药	 电影
超凡蜘蛛侠	 电影
无敌浩克	 电影
降临	 电影
v字仇杀队	 电影
钢铁侠2	 电影
美国队长2	 电影
银翼杀手2049	 电影
十二猴子	 电影
猩球崛起3	 电影
汉江怪物	 电影
星际迷航2	 电影
银翼杀手	 电影
女超人	 电影
饥饿游戏	 电影
活死人之地	 电影
极度深寒	 电影
源代码	 电影
妖兽都市	 电影
超级战舰	 电影
机器人总动员	 电影
北海巨妖	 电影
惊变28天	 电影
雪国列车	 电影
第九区	 电影
复仇者联盟	 电影
白鹿原	 电影
银魂	 电影
钢铁侠3	 电影
芳华	 电影
妖猫传	 电影
寻梦环游记	 电影
骑士	 电影
扶摇	 电影
红海行动	 电影
金蝉脱壳	 电影
蜘蛛侠	 电影
麻将	 电影
极品飞车	 电影
杀破狼	 电影
驯龙高手2	 电影
阿甘正传	 电影
微商	 电影
致我们终将逝去的青春	 电影
天台	 电影
水形物语	 电影
扫毒	 电影
普罗米修斯	 电影
杀人回忆	 电影
国产凌凌漆	 电影
黄飞鸿	 电影
超凡蜘蛛侠	 电影
婚前试爱	 电影
雷神2：黑暗世界	 电影
维京	 电影
圣安地列斯	 电影
少年派的奇幻漂流	 电影
机械师	 电影
黑金	 电影
钢铁侠2	 电影
阿飞正传	 电影
火柴人	 电影
奇迹	 电影
太阳照常升起	 电影
悟空传	 电影
银翼杀手2049	 电影
同桌的你	 电影
地狱神探	 电影
追捕	 电影
赤裸特工	 电影
电锯惊魂8	 电影
猩球崛起3	 电影
逃出生天	 电影
春娇与志明	 电影
谍影重重	 电影
环太平洋：雷霆再起	 电影
西游记女儿国	 电影
蓝色金鱼	 电影
复仇者联盟	 电影
白鹿原	 电影
古墓丽影	 电影
银魂	 电影
钢铁侠3	 电影
芳华	 电影
天黑请闭眼	 电影
妖猫传	 电影
寻梦环游记	 电影
星球大战8	 电影
天生一对	 电影
三体	 电影
骑士	 电影
终结者2	 电影
湮灭	 电影
微微一笑很倾城	 电影
水浒传	 电影
x战警	 电影
了不起的盖茨比	 电影
霸王别姬	 电影
肖申克的救赎	 电影
愤怒的小鸟	 电影
灵魂摆渡黄泉	 电影
人工智能	 电影
盗墓笔记	 电影
正义联盟	 电影
李连杰	 电影
台湾往事	 电影
斗地主	 电影
左耳	 电影
与神同行	 电影
羞羞的铁拳	 电影
缝纫机乐队	 电影
爱因斯坦	 电影
十二生肖	 电影
帕丁顿熊2	 电影
扶摇	 电影
侏罗纪世界	 电影
侏罗纪世界2	 电影
复仇者联盟3：无限战争	 电影
孔子	 电影
狂暴巨兽	 电影
使命召唤	 电影
金蝉脱壳2	 电影
死侍2	 电影
侏罗纪公园	 电影
生死狙击	 电影
仓鼠	宠物
猛虎	宠物
阿富汗猎犬	宠物
阿拉斯加雪橇犬	宠物
巴哥犬	宠物
巴吉度猎犬	宠物
斑点狗	宠物
北京犬	宠物
比格犬	宠物
边境牧羊犬	宠物
博美	宠物
大白熊犬	宠物
德国牧羊犬	宠物
贵宾犬	宠物
哈士奇	宠物
蝴蝶犬	宠物
吉娃娃	宠物
金毛	宠物
金毛寻回犬	宠物
京巴犬	宠物
卷毛比熊犬	宠物
拉布拉多	宠物
拉布拉多寻回犬	宠物
腊肠犬	宠物
拉萨犬	宠物
罗威纳犬	宠物
美国爱斯基摩犬	宠物
美国可卡犬	宠物
迷你杜宾犬	宠物
迷你雪纳瑞	宠物
彭布罗克威尔士柯基	宠物
日本银狐	宠物
绒毛犬	宠物
萨摩耶	宠物
萨摩耶德犬	宠物
萨摩耶犬	宠物
圣伯纳犬	宠物
松狮犬	宠物
松鼠犬	宠物
苏格兰牧羊犬	宠物
苏牧	宠物
西伯利亚雪橇犬	宠物
西部高地白梗	宠物
喜乐蒂牧羊犬	宠物
西施犬	宠物
雪纳瑞	宠物
意大利灵缇犬	宠物
英国斗牛犬	宠物
约克夏梗	宠物
藏獒	宠物
中国沙皮犬	宠物
中华田园犬	宠物
阿里巴巴	企业
阿里	企业
港股	企业
港交所	企业
美股	企业
纳斯达克	企业
纽交所	企业
腾讯控股	企业
工商银行	企业
农业银行	企业
人民银行	企业
中国央行	企业
招商银行	企业
建设银行	企业
汇丰银行	企业
上海银行	企业
宁波银行	企业
江苏银行	企业
渣打银行	企业
中国银行	企业
内蒙古银行	企业
交通银行	企业
雪盈证券	企业
盈透证券	企业
腾讯	企业
谷歌	企业
google	企业
Google	企业
facebook	企业
Facebook	企业
脸书	企业
亚马逊	企业
Amazon	企业
amazon	企业
腾讯云	企业
亚马逊云	企业
阿里云	企业
百度云	企业
百度	企业
京东	企业
字节跳动	企业
今日头条	企业
京东京点	企业
抖音	企业
快手	企业
科大讯飞	企业
商汤科技	企业
饿了么	企业
ofo	企业
摩拜	企业
美团	企业
喜茶	企业
滴滴	企业
华为	企业
中兴	企业
龙芯	企业
微视	企业
中国联通	企业
中国电信	企业
中国移动	企业
高通	企业
西门子	企业
华大基因	企业
光线传媒	企业
快乐大本营	 综艺
天天向上	 综艺
新视觉	 综艺
爱情保卫战	 综艺
财经郎眼	 综艺
鲁豫有约	 综艺
康熙来了	 综艺
金牌调解	 综艺
非常静距离	 综艺
国光帮帮忙	 综艺
锵锵三人行	 综艺
对话	 综艺
脱口秀大会	 综艺
大王小王	 综艺
说出你的故事	 综艺
关键时刻	 综艺
可凡倾听	 综艺
8090	 综艺
忏悔录	 综艺
春妮的周末时光	 综艺
杨澜访谈录	 综艺
面对面	 综艺
勇往直前	 综艺
乡约	 综艺
相约星期六	 综艺
小崔说事	 综艺
happy together	 综艺
平安365	 综艺
艺术人生	 综艺
新闻当事人	 综艺
生活广角	 综艺
文明之旅	 综艺
明星夫妻秀	 综艺
大戏看北京	 综艺
影视风云路	 综艺
超级访问	 综艺
男女纠察队	 综艺
波士堂	 综艺
大学生了没	 综艺
王牌大贱谍	 综艺
深度观察	 综艺
头脑风暴	 综艺
婚姻保卫战	 综艺
谁在说	 综艺
非诚勿扰	 综艺
爱情保卫战	 综艺
金牌调解	 综艺
夜线	 综艺
非常静距离	 综艺
国光帮帮忙	 综艺
我们结婚了	 综艺
男生女生向前冲	 综艺
大王小王	 综艺
我们相爱吧	 综艺
全城热恋	 综艺
可凡倾听	 综艺
8090	 综艺
非常完美	 综艺
钱塘老娘舅	 综艺
杨澜访谈录	 综艺
调解面对面	 综艺
如果爱	 综艺
向幸福出发	 综艺
相约星期六	 综艺
生活广角	 综艺
相亲才会赢	 综艺
明星夫妻秀	 综艺
影视风云路	 综艺
走进大戏台	 综艺
幸福账单	 综艺
百里挑一	 综艺
中国梦想秀	 综艺
我们约会吧	 综艺
欢乐集结号	 综艺
大学生了没	 综艺
新老娘舅	 综艺
王牌大贱谍	 综艺
深度观察	 综艺
心理访谈	 综艺
婚姻保卫战	 综艺
花样年华	 综艺
王者归来	 综艺
中国新歌声	 综艺
非你莫属	 综艺
全城热恋	 综艺
中国好歌曲	 综艺
年代秀	 综艺
最优的我们	 综艺
调解面对面	 综艺
妈妈咪呀	 综艺
梦想演播厅	 综艺
势不可挡	 综艺
舞出我人生	 综艺
快乐男声	 综艺
相亲才会赢	 综艺
一呼百应	 综艺
中国梦之声	 综艺
职来职往	 综艺
家族诞生	 综艺
中国梦想秀	 综艺
顶级厨师	 综艺
歌从黄河来	 综艺
大学生了没	 综艺
舞林大会	 综艺
最美和声	 综艺
英国达人秀	 综艺
快乐大本营	 综艺
极限挑战	 综艺
王者归来	 综艺
向往的生活	 综艺
奔跑吧兄弟	 综艺
天天向上	 综艺
极限挑战第四季	 综艺
偶像练习生	 综艺
非诚勿扰	 综艺
无限歌谣季	 综艺
新视觉	 综艺
晓说	 综艺
高能少年团	 综艺
欢乐喜剧人	 综艺
笑傲江湖	 综艺
中国新歌声	 综艺
爱情保卫战	 综艺
昆仑决	 综艺
奇葩说	 综艺
财经郎眼	 综艺
青春同学会	 综艺
蒙面唱将猜猜猜	 综艺
海峡新干线	 综艺
非你莫属	 综艺
天下足球	 综艺
武林风	 综艺
深度国际	 综艺
爸爸去哪儿	 综艺
防务新观察	 综艺
热血街舞团	 综艺
直播港澳台	 综艺
中国新说唱	 综艺
环球视线	 综艺
金牌调解	 综艺
军情解码	 综艺
老梁故事汇	 综艺
火星情报局	 综艺
中餐厅	 综艺
夜线	 综艺
偶像来了	 综艺
健康之路	 综艺
我是歌手	 综艺
非常静距离	 综艺
世界周刊	 综艺
最强大脑	 综艺
养生堂	 综艺
致富经	 综艺
一站到底	 综艺
花儿与少年	 综艺
机器人争霸	 综艺
康熙来了	 综艺
国光帮帮忙	 综艺
锵锵三人行	 综艺
美女厨房	 综艺
女人我最大	 综艺
凤凰大视野	 综艺
wto姐妹会	 综艺
娱乐百分百	 综艺
世界第一等	 综艺
一虎一席谈	 综艺
一袋女王	 综艺
时事辩论会	 综艺
名人面对面	 综艺
大学生了没	 综艺
王牌大贱谍	 综艺
新闻今日谈	 综艺
天才冲冲冲	 综艺
快乐大本营	 综艺
天生一对	 综艺
中国情歌汇	 综艺
极限挑战	 综艺
王者归来	 综艺
创造101	 综艺
向往的生活	 综艺
奔跑吧兄弟	 综艺
天天向上	 综艺
奔跑吧	 综艺
我是大侦探	 综艺
极限挑战第四季	 综艺
偶像练习生	 综艺
非诚勿扰	 综艺
无限歌谣季	 综艺
跨界歌王	 综艺
我想和你唱	 综艺
今日说法	 综艺
拜托了冰箱	 综艺
新相亲时代	 综艺
明星大侦探	 综艺
新视觉	 综艺
放开我北鼻	 综艺
晓说	 综艺
我爱我家	 综艺
陈翔六点半	 综艺
这就是铁甲	 综艺
running man	 综艺
智慧树	 综艺
妈妈是超人	 综艺
王牌对王牌	 综艺
高能少年团	 综艺
欢乐喜剧人	 综艺
笑傲江湖	 综艺
中国新歌声	 综艺
朗读者	 综艺
爱情保卫战	 综艺
开讲啦	 综艺
吐槽大会	 综艺
不可思议的妈妈	 综艺
荒野求生	 综艺
百家讲坛	 综艺
动物世界	 综艺
昆仑决	 综艺
奇葩说	 综艺
财经郎眼	 综艺
青春同学会	 综艺
这就是街舞	 综艺
靳东	 热点
刘强东	 热点
金正恩	 热点
孙兴	 热点
崔西	 热点
孙艺珍	 热点
吴镇宇	 热点
章丘	 热点
奥迪	 热点
林更新	 热点
王丽坤	 热点
沙特队	 热点
卡利尼奇	 热点
韩天宇	 热点
刘秋宏	 热点
京哈高速	 热点
贝佐斯	 热点
小米	 热点
肥西小区	 热点
富士胶片	 热点
施乐	 热点
薛之谦	 热点
内马尔	 热点
梅西	 热点
比伯海莉	 热点
京哈高速	 热点
小豌豆	 热点
罗伊斯	 热点
王东明	 热点
张艺谋	 热点
瑞士	 热点
科拉罗夫	 热点
兰多夫	 热点
邓超	 热点
库蒂尼奥	 热点
博尔特	 热点
欧阳娜娜	 热点
哈佛	 热点
博格巴	 热点
端午	 热点
杨文昊	 热点
特朗普	 热点
冯提莫	 热点
周星驰	 热点
薛之谦	 热点
吴彦祖	 热点
内马尔	 热点
吴建豪	 热点
陈奕迅	 热点
吴秀波	 热点
迪奥	 热点
宝马	 热点
陈都灵	 热点
邓超	 热点
c罗	 热点
杜兰特	 热点
兰多夫	 热点
欧阳娜娜	 热点
伯克利	 热点
刘德华	 热点
王东明	 热点
比利时	 热点
瑞典	 热点
哈佛	 热点
端午	 热点
中秋节	 热点
薛之谦	 热点
比伯海莉	 热点
张艺谋	 热点
邓超	 热点
欧阳娜娜	 热点
杨幂工作室	 热点
c罗	 热点
陈都灵	 热点
叶璇	 热点
范冰冰	 热点
范丞丞	 热点
吴建豪	 热点
余文乐	 热点
杨文昊	 热点
冯提莫	 热点
特朗普	 热点
王力宏	 热点
周星驰	 热点
刘昊然	 热点
欧阳娜娜	 热点
翟天临	 热点
陈意涵	 热点
欧阳娜娜	 热点
伯克利	 热点
章鱼保罗	 热点
陈奕迅	 热点
吴秀波	 热点
吴彦祖	 热点
刘德华	 热点
罗晋	 热点
唐嫣	 热点
格策	 热点
伊能静	 热点
崔永元	 热点
范冰冰	 热点
花木兰	 热点
凯特王妃	 热点
内马尔	 热点
梅西	 热点
罗伊斯	 热点
科拉罗夫	 热点
兰多夫	 热点
库蒂尼奥	 热点
博尔特	 热点
博格巴	 热点
马拉多纳	 热点
奥乔亚	 热点
马拉多纳	 热点
c罗	 热点
梅西	 热点
中国男排	 热点
克罗地亚	 热点
尼日利亚	 热点
费德勒	 热点
马塞洛	 热点
内马尔	 热点
Yeezy	生活
yeezy	生活
华为	生活
小米	生活
OPPO	生活
魅族	生活
vivo	生活
VIVO	生活
oppo	生活
锤子科技	生活
联想	生活
努比亚	生活
三星	生活
美图	生活
金立	生活
奇酷	生活
索尼	生活
中兴	生活
ivvi	生活
朵唯手机	生活
乐视	生活
飞利浦	生活
天语手机	生活
天猫	生活
京东	生活
小红书	生活
淘宝	生活
唯品会	生活
苏宁	生活
当当网	生活
美丽说	生活
魅力惠	生活
网易考拉	生活
亚马逊	生活
韩国艺匠	生活
唯一视觉	生活
金夫人婚纱摄影	生活
蒙娜丽莎	生活
薇拉摄影	生活
克洛伊	生活
肯德基	生活
麦当劳	生活
汉堡王	生活
西贝莜面村	生活
海底捞	生活
必胜客	生活
星巴克	生活
喜茶	生活
烹火	生活
独角兽咖啡	生活
可口可乐	生活
伊利	生活
农夫山泉	生活
蒙牛	生活
南方黑芝麻	生活
合生元	生活
荣耀手机	生活
adidas	生活
阿迪达斯	生活
李宁	生活
iPhone X	生活
iPhone	生活
科沃斯	生活
戴森	生活
联发科	生活
清华	教育
北大	教育
清华大学	教育
北京大学	教育
MIT	教育
常青藤	教育
杜克大学	教育
剑桥	教育
剑桥大学	教育
牛津大学	教育
牛津	教育
帝国理工	教育
天津大学	教育
南开大学	教育
哈工大	教育
哈尔滨工业大学	教育
哈理工	教育
哈工程	教育
哈尔滨理工大学	教育
哈尔滨工程大学	教育
华中科技大学	教育
华南理工大学	教育
河南大学	教育
华科	教育
北师大	教育
北京师范大学	教育
北航	教育
北京航空航天大学	教育
复旦大学	教育
复旦	教育
上海交大	教育
上海交通大学	教育
浙江大学	教育
西安交大	教育
西安交通大学	教育
浙大	教育
麻省理工	教育
华盛顿大学	教育
哈弗	教育
哈佛大学	教育
伦敦政经	教育
西南政法	教育
中科院	教育
北师大附中	教育
港大	教育
港中文	教育
港科大	教育
香港大学	教育
香港中文大学	教育
同济大学	教育
中山大学	教育
南京大学	教育
西安电子科技大学	教育
香港科技大学	教育
曼大	教育
曼彻斯特大学	教育
爱丁堡大学	教育
苏黎世联邦理工	教育
ZTH	教育
ETH	教育
伯克利	教育
中考	教育
中高考	教育
高考	教育
小升初	教育
SAT	教育
GRE	教育
A-Level	教育
雅思	教育
GPA	教育
新东方	教育
蓝翔	教育
东北大学	教育
携程	旅游
驴妈妈	旅游
去哪网	旅游
穷游	旅游
马蜂窝	旅游
途牛	旅游
马尔代夫	旅游
大溪地	旅游
威尼斯	旅游
河内	旅游
魁北克	旅游
冰岛	旅游
丹麦	旅游
挪威	旅游
大理	旅游
丽江	旅游
泸沽湖	旅游
乌镇	旅游
西安	旅游
兵马俑	旅游
长城	旅游
莫高窟	旅游
佳木斯	旅游
哈尔滨	旅游
查干湖	旅游
凤凰古城	旅游
香格里拉	旅游
昆明	旅游
玉龙雪山	旅游
长白山	旅游
泰山	旅游
华山	旅游
西双版纳	旅游
桂林	旅游
香港迪士尼	旅游
上海迪士尼	旅游
故宫	旅游
颐和园	旅游
圆明园	旅游
山海关	旅游
嘉峪关	旅游
玉门关	旅游
龙门石窟	旅游
乐山大佛	旅游
普陀岛	旅游
九寨沟	旅游
香港	旅游
罗平	旅游
西溪湿地	旅游
平遥古城	旅游
北海道	旅游
台北	旅游
故宫博物院	旅游
天安门	旅游
紫禁城	旅游
西湖	旅游
大明寺	旅游
宏村	旅游
婺源	旅游
黄山	旅游
鼓浪屿	旅游
八达岭	旅游
张家界	旅游
布达拉宫	旅游
名古屋	旅游
黄金海岸	旅游
黄金周	旅游
小长假	旅游
墨尔本	旅游
布里斯班	旅游
杭州	旅游
爱丁堡	旅游
曼彻斯特	旅游
约克	旅游
巴斯	旅游
剑桥	旅游
牛津	旅游
旧金山	旅游
拉斯维加斯	旅游
威尼斯人酒店	旅游
龙泉寺	旅游
尼亚加拉瀑布	旅游
亚马逊丛林	旅游
黄石国家公园	旅游
西雅图	旅游
武夷山	旅游
庐山	旅游
五台山	旅游
西岭雪山	旅游
香山公园	旅游
大理古城	旅游
西街	旅游
日月潭	旅游
青云山	旅游
大峡谷	旅游
南田温泉	旅游
皇城相府	旅游
镇北堡	旅游
富士山	旅游
普罗旺斯	旅游
撒哈拉	旅游
塞纳河	旅游
多瑙河	旅游
巴黎铁塔	旅游
埃菲尔铁塔	旅游
台北101	旅游
泰姬陵	旅游
吴哥窟	旅游
巴黎圣母院	旅游
金字塔	旅游
白金汉宫	旅游
凯旋门	旅游
沙巴	旅游
峨眉山	旅游
国航	旅游
南航	旅游
深航	旅游
海航	旅游
英航	旅游
维珍	旅游
阿别阿布	歌手
阿斌	歌手
阿大阿奇	歌手
阿底阿吉	歌手
阿迪木牛	歌手
阿迪小斌	歌手
阿雕	歌手
阿都子曲	歌手
阿尔金海	歌手
阿尔木果	歌手
阿干阿布	歌手
阿果赤古	歌手
阿侯尔里	歌手
阿候尔里	歌手
阿吉	歌手
阿吉太组合	歌手
阿甲鲁月	歌手
阿进	歌手
阿景阿吉	歌手
阿景阿印	歌手
阿景曲古	歌手
阿库诗薇	歌手
阿库乌雾	歌手
阿勒长青	歌手
阿鲁阿格	歌手
阿鲁阿卓	歌手
阿鲁卡素	歌手
阿洛曲色	歌手
阿木尼布弟	歌手
阿诺阿布	歌手
阿诺乐队	歌手
阿谱	歌手
阿铺阿鲁	歌手
阿铺鲁尼	歌手
阿铺素卡	歌手
阿普呷呷	歌手
阿铺依尼	歌手
阿铺姿果	歌手
阿惹组合	歌手
阿日阿芝	歌手
阿生比吉	歌手
阿说阿木	歌手
阿四龙	歌手
阿苏体史	歌手
阿苏伊古	歌手
阿苏依古	歌手
阿苏依森古都	歌手
阿韦青青	歌手
阿韦曲古	歌手
阿维姿朵	歌手
阿文曲布	歌手
阿吾比拉	歌手
阿西里西	歌手
阿西木牛	歌手
阿依果果	歌手
阿依洛	歌手
阿依梅朵	歌手
阿依木木	歌手
阿印	歌手
阿哲阿弘	歌手
阿哲阿木	歌手
阿哲阿孜	歌手
阿姿阿巴	歌手
奥吉戈卡	歌手
奥杰阿格	歌手
奥杰阿黑	歌手
奥杰阿且	歌手
巴嫫安捷	歌手
巴莫安杰	歌手
白里格	歌手
布火有呷	歌手
查尔木嘎	歌手
陈云	歌手
驰知瑟密	歌手
的莫沙沙	歌手
的莫莎莎	歌手
东方圣火组织	歌手
俄地日伙	歌手
俄木阿鸿	歌手
俄木果果	歌手
俄木金洛	歌手
俄木木果	歌手
俄木依依	歌手
非明荣	歌手
格萨拉组合	歌手
果果嫫	歌手
海来阿卓	歌手
黑来阿木	歌手
黑山彝人组合	歌手
黄信驰	歌手
火舞布落	歌手
火焰奇迹组合	歌手
火彝兄弟	歌手
火之子	歌手
吉布红英	歌手
吉布尼合	歌手
吉狄康帅	歌手
吉狄马加	歌手
吉地色呷	歌手
吉胡阿力	歌手
吉吉杰布	歌手
吉克杰拉	歌手
吉克隽逸	歌手
吉克木呷	歌手
吉克曲布	歌手
吉克永都	歌手
吉克子古	歌手
吉里日曰	歌手
季琳	歌手
吉木色日	歌手
吉木喜儿	歌手
吉拿羊立	歌手
吉牛作且	歌手
吉潘木乃	歌手
吉日莫铁江波	歌手
吉瓦拉则	歌手
吉则日谷	歌手
贾巴阿三	歌手
贾巴吉杰	歌手
甲巴尼古	歌手
甲尼古	歌手
佳桑柯布	歌手
江石布	歌手
杰爵使者	歌手
金古阿迁	歌手
金古金彩	歌手
金古务林	歌手
金丝鸟组合	歌手
九零部落	歌手
拉一阿加莫	歌手
老彝腔组合	歌手
勒尔吉哈	歌手
勒者阿则	歌手
李晓峰	歌手
连扎妹妹	歌手
鲁弘阿立	歌手
鲁家辉	歌手
陆志刚	歌手
罗阿洪	歌手
洛比约呷	歌手
倮五阿木	歌手
罗学军	歌手
马布声音组合	歌手
玛海	歌手
马海五达	歌手
马嘿阿洛	歌手
马嘿阿依	歌手
马建鹏	歌手
马惹童童阿龙	歌手
马云峰	歌手
麦吉布都	歌手
莫色大虎	歌手
莫西宇东	歌手
莫西子诗	歌手
慕俄格组合	歌手
牧云传奇组合	歌手
纳苏李鹏	歌手
乃文娟	歌手
南方叶子	歌手
南玛子呷	歌手
南彝组合	歌手
尼诺克哲	歌手
诺苏阿一	歌手
期沙子虫	歌手
启塔乐团	歌手
千撒乌呷	歌手
邱蓉	歌手
曲比阿果	歌手
曲比阿且	歌手
曲比哈布	歌手
曲比哈日	歌手
曲比兴义	歌手
曲比卓洛	歌手
曲莫秋天	歌手
曲莫约呷	歌手
曲木古火	歌手
曲木伍合	歌手
惹古忍	歌手
热柯万年	歌手
色特比且	歌手
沙嘎阿依	歌手
沙玛阿布	歌手
沙玛阿果	歌手
沙玛阿妞	歌手
沙玛布莱	歌手
沙玛尔火	歌手
沙玛尔西	歌手
沙玛古洛	歌手
沙玛拉且	歌手
沙马拉日	歌手
沙玛木干	歌手
沙玛木呷	歌手
沙玛诗薇	歌手
沙玛巫牛	歌手
沙玛学锋	歌手
沙玛洋佳	歌手
沙晓芳	歌手
杉和	歌手
山鹰组合	歌手
史吐阿育	歌手
苏都阿洛	歌手
太阳部落	歌手
土豆兄弟组合	歌手
吐珠鲁卡	歌手
瓦其依合	歌手
翁古永都	歌手
乌撒部落	歌手
先生组合	歌手
肖洋	歌手
行走乡谣组合	歌手
杨学良	歌手
彝都人组合	歌手
依火里火	歌手
彝人传奇	歌手
彝人制造	歌手
彝组合	歌手
约里	歌手
云飞	歌手
再见彝人	歌手
张新民	歌手
支嘎依其	歌手
张学友	歌手
Jessie J	歌手
jessie j	歌手
洁西	歌手
范特西	歌手
方世杰	歌手
方文山	歌手
桂纶镁	歌手
吴宗宪	歌手
徐若瑄	歌手
叶惠美	歌手
周董	歌手
吴小然	歌手
周杰伦	歌手
陈丽	歌手
蒋申	歌手
赖美云	歌手
林慧	歌手
秦瑜	歌手
潼潼	歌手
吴瑶	歌手
许诗茵	歌手
艾芷亦	歌手
安可路	歌手
柏欣妤	歌手
毕梦媛	歌手
毕瑞珊	歌手
曾晓雯	歌手
曾小野	歌手
曾艳芬	歌手
曾妖风	歌手
曾誉嘉	歌手
程文路	歌手
程以恩	歌手
程一心	歌手
橙子雨	歌手
程子钰	歌手
虫之诗	歌手
聪冉	歌手
聪璇	歌手
代玲	歌手
戴欣佚	歌手
代役	歌手
戴紫薇	歌手
丹三老师	歌手
蛋藤	歌手
邓惠恩	歌手
邓倩	歌手
邓艳秋菲	歌手
刁滢	歌手
丁紫妍	歌手
董思佳	歌手
董艳芸	歌手
董芷依	歌手
杜秋霖	歌手
杜雨微	歌手
毒蜘蛛	歌手
段艺璇	歌手
朵娜	歌手
恩瑾	歌手
恩穗	歌手
梵梵	歌手
番薯彪	歌手
樊曦月	歌手
方方兔	歌手
房蕾	歌手
方诗涵	歌手
方晓瑜	歌手
费沁源	歌手
肥秋	歌手
肥蕊	歌手
霏芝	歌手
芬骑	歌手
芬束	歌手
冯嘉希	歌手
冯思佳	歌手
冯晓菲	歌手
冯薪朵	歌手
冯雪莹	歌手
冯译莹	歌手
符冰冰	歌手
付奕萱	歌手
付紫琪	歌手
戆卵	歌手
高崇	歌手
高国庆	歌手
高蔚然	歌手
高雪逸	歌手
高源婧	歌手
高志娴	歌手
葛佳慧	歌手
革青韦	歌手
葛司琪	歌手
龚堃	歌手
龚梦婷	歌手
龚诗淇	歌手
宫泽佐江	歌手
顾村拓哉	歌手
顾香君	歌手
关思雨	歌手
滚出克	歌手
郭美孜	歌手
郭倩芸	歌手
郭铱宁	歌手
海风的请柬	歌手
韩家乐	歌手
韩林芹	歌手
郝婧怡	歌手
郝婉晴	歌手
何梦瑶	歌手
河情河理	歌手
河式路人	歌手
贺苏堃	歌手
何晓玉	歌手
何阳青青	歌手
何轶琛	歌手
黑琪军	歌手
黑天鹅	歌手
阿易	歌手
俊俊	歌手
俊凯	歌手
凯宝	歌手
凯皇	歌手
凯凯	歌手
凯爷	歌手
凯源	歌手
凯源盛世	歌手
凯源汪	歌手
千玺	歌手
千智赫	歌手
千总	歌手
王俊凯	歌手
王俊凯同款	歌手
王俊腿	歌手
玺烊烊	歌手
玺子哥	歌手
小凯	歌手
小千千	歌手
小源	歌手
烊少	歌手
烊五爷	歌手
烊烊	歌手
易烊千玺	歌手
易阵风	歌手
易总	歌手
源宝	歌手
源哥	歌手
源源	歌手
陈芳语	歌手
陈嘉桦	歌手
陈怡凡	歌手
陈意涵	歌手
陈盈燕	歌手
陈语嫣	歌手
丑丑	歌手
杜金雨	歌手
段奥娟	歌手
范薇	歌手
傅菁	歌手
高秋梓	歌手
葛佳慧	歌手
勾雪莹	歌手
韩丹	歌手
胡彦斌	歌手
胡悦儿	歌手
黄子韬	歌手
江璟儿	歌手
蒋申	歌手
姜彦汐	歌手
焦曼婷	歌手
菊麟	歌手
赖美云	歌手
李天韵	歌手
李紫婷	歌手
李子璇	歌手
林珈安	歌手
林君怡	歌手
刘丹萌	歌手
刘德熙	歌手
刘佳莹	歌手
刘尼夷	歌手
刘念	歌手
刘人语	歌手
刘思纤	歌手
刘宇珊	歌手
鹿小草	歌手
罗天舒	歌手
罗奕佳	歌手
罗怡恬	歌手
罗志祥	歌手
罗智仪	歌手
吕小雨	歌手
马兴钰	歌手
毛唯嘉	歌手
孟美岐	歌手
倪秋云	歌手
潘珺雅	歌手
戚砚笛	歌手
强东玥	歌手
邱路晴	歌手
任真	歌手
芮萌	歌手
少女有态度	歌手
邵夏	歌手
声乐导师	歌手
苏芮琪	歌手
王珏萌	歌手
王曼君	歌手
王莫涵	歌手
王晴	歌手
王婷	歌手
王雅凛	歌手
王一博	歌手
王亦然	歌手
魏瑾	歌手
未来不迷茫	歌手
吴茜	歌手
吴小萱	歌手
吴宣仪	歌手
吴映香	歌手
吴昀廷	歌手
夏诗洁	歌手
向俞星	歌手
许靖韵	歌手
徐梦洁	歌手
许诗茵	歌手
颜可欣	歌手
杨冰	歌手
杨超越	歌手
杨晗	歌手
杨美玲	歌手
杨美琪	歌手
杨蕊菡	歌手
杨芸晴	歌手
尹柔懿	歌手
尹蕊	歌手
于美红	歌手
张楚寒	歌手
张杰	歌手
张静萱	歌手
张溪	歌手
张新洁	歌手
张鑫磊	歌手
张馨月	歌手
张瑜纹	歌手
赵羚	歌手
赵尧珂	歌手
郑丞丞	歌手
直拍	歌手
周雪	歌手
朱佳希	歌手
朱天天	歌手
紫宁	歌手
百分九女孩	歌手
邦邦	歌手
贝汯璘	歌手
毕雯珺	歌手
冰帝	歌手
卜凡	歌手
蔡徐坤	歌手
参与感	歌手
藏狐	歌手
超能唱片	歌手
陈立农	歌手
陈名豪	歌手
陈斯琪	歌手
辰星娱乐	歌手
陈义夫	歌手
程潇	歌手
大侄子	歌手
邓烺怡	歌手
点星文化	歌手
丁泽仁	歌手
董岩磊	歌手
董眼泪	歌手
董又霖	歌手
范丞丞	歌手
凤姐	歌手
甘俊	歌手
高茂桐	歌手
果然娱乐	歌手
韩沐伯	歌手
韩雍杰	歌手
昊昊	歌手
何东东	歌手
何嘉庚	歌手
红熠文化	歌手
侯浩然	歌手
胡致邦	歌手
华谊兄弟	歌手
华谊兄弟时尚	歌手
黄明昊	歌手
黄若涵	歌手
黄书豪	歌手
黄新淳	歌手
贾富贵	歌手
伽里	歌手
姜达赫	歌手
姜京佐	歌手
捷特联合	歌手
金逸涵	歌手
金庸三宝	歌手
靖佩瑶	歌手
举铁小哥	歌手
觉醒东方	歌手
坤坤	歌手
坤音娱乐	歌手
乐风艺社	歌手
乐华娱乐	歌手
雷震子	歌手
冷彦俊	歌手
李长庚	歌手
李俊毅	歌手
李权哲	歌手
李让	歌手
李荣浩	歌手
李若天	歌手
李希侃	歌手
李鑫岩	歌手
李志杰	歌手
栗子	歌手
梁辉	歌手
林超泽	歌手
林浩楷	歌手
林彦俊	歌手
灵超	歌手
灵超小王子	歌手
凌崎	歌手
娄滋博	歌手
鹿袋鼠	歌手
陆定昊	歌手
罗杰	歌手
罗仁麒	歌手
罗正	歌手
吕晨瑜	歌手
妈妈粉	歌手
麦锐娱乐	歌手
闵喆祥	歌手
明鹏	歌手
沐沐	歌手
木子洋	歌手
农小葵	歌手
欧阳靖	歌手
钱正昊	歌手
秦奋	歌手
覃俊毅	歌手
秦子墨	歌手
邱治谐	歌手
全民制作人	歌手
锐姐	歌手
山歌少年	歌手
少林弟子	歌手
盛夏星空	歌手
双向关系	歌手
孙凡杰	歌手
孙浩然	歌手
她经济	歌手
天津中视	歌手
万宇贤	歌手
王嘉尔	歌手
王琳凯	歌手
王艺龙	歌手
王宥辰	歌手
王梓豪	歌手
王子异	歌手
武连杰	歌手
武藏	歌手
香蕉娱乐	歌手
小鱼儿	歌手
小猪佩奇	歌手
新湃传媒	歌手
新锐杂志	歌手
徐鹤尼	歌手
许凯皓	歌手
徐圣恩	歌手
亚歌文化	歌手
养成系偶像	歌手
杨非同	歌手
杨羿	歌手
叶泓希	歌手
野火娱乐	歌手
姨娘	歌手
英皇娱乐	歌手
应智越	歌手
尤长靖	歌手
于斌	歌手
于浩	歌手
余明君	歌手
岳岳	歌手
张达源	歌手
张津铭	歌手
张昕	歌手
张晏恺	歌手
张艺凡	歌手
张艺兴	歌手
张奕轩	歌手
张宇晨	歌手
赵凌峰	歌手
赵俞澈	歌手
郑锐彬	歌手
周洁琼	歌手
周美锐	歌手
周锐	歌手
周腾阳	歌手
周彦辰	歌手
朱星杰	歌手
朱一文	歌手
朱匀天	歌手
朱匀一	歌手
主宰权	歌手
朱正廷	歌手
左叶	歌手
突尼斯	 生活
香港	 生活
大阪	 生活
青岛	 生活
新加坡	 生活
厦门	 生活
莫斯科	 生活
澳门	 生活
西双版纳	 生活
巴厘岛	 生活
济南	 生活
黄山	 生活
乌镇	 生活
梵蒂冈	 生活
马尔代夫	 生活
三亚	 生活
迪拜	 生活
威尼斯	 生活
东京	 生活
丽江	 生活
香格里拉	 生活
威海	 生活
烟台	 生活
临沂	 生活
鼓浪屿	 生活
普吉岛	 生活
都江堰	 生活
塞班岛	 生活
千岛湖	 生活
大亚湾	 生活
长岛	 生活
五台山	 生活
京都	 生活
摩纳哥	 生活
济宁	 生活
井冈山	 生活
圣彼得堡	 生活
潍坊	 生活
洞庭湖	 生活
武夷山	 生活
玉龙雪山	 生活
马鞍山	 生活
巴塞罗那	 生活
莫干山	 生活
夏威夷	 生活
大理	 生活
峨眉山	 生活
普陀山	 生活
拉斯维加斯	 生活
故宫	 生活
汨罗江	 生活
九寨沟	 生活
华山	 生活
颐和园	 生活
泰山	 生活
北戴河	 生活
八达岭长城	 生活
圆明园	 生活
牟尼沟	 生活
五台山	 生活
死海	 生活
庐山	 生活
洪崖洞	 生活
洱海	 生活
西湖	 生活
峨眉山	 生活
普陀山	 生活
火焰山	 生活
乐山大佛	 生活
上海博物馆	 生活
布达拉宫	 生活
武当山	 生活
秦始皇陵	 生活
壶口瀑布	 生活
白云山	 生活
陕西历史博物馆	 生活
鸟巢	 生活
拙政园	 生活
周庄	 生活
苏州博物馆	 生活
宋城	 生活
云台山	 生活
天门山	 生活
四姑娘山	 生活
东林书院	 生活
天池	 生活
天涯海角	 生活
滕王阁	 生活
大雁塔	 生活
中山陵	 生活
天安门广场	 生活
崂山	 生活
北海公园	 生活
灵山	 生活
雍和宫	 生活
萧山	 生活
城隍庙	 生活
太行山	 生活
灵隐寺	 生活
故宫博物院	 生活
上海博物馆	 生活
陕西历史博物馆	 生活
苏州博物馆	 生活
南京博物院	 生活
中国国家博物馆	 生活
湖南省博物馆	 生活
湖北省博物馆	 生活
建川博物馆	 生活
台北故宫博物院	 生活
河南博物院	 生活
哈士奇	 生活
布偶猫	 生活
拉布拉多	 生活
萨摩耶	 生活
金毛	 生活
秋田犬	 生活
八哥	 生活
博美犬	 生活
英国短毛猫	 生活
茶杯犬	 生活
仓鼠	 生活
吉娃娃	 生活
清道夫	 生活
暹罗猫	 生活
贵宾犬	 生活
德国牧羊犬	 生活
藏獒	 生活
比熊	 生活
美国恶霸犬	 生活
雪纳瑞	 生活
龙猫	 生活
变色龙	 生活
蝴蝶犬	 生活
波斯猫	 生活
中华田园犬	 生活
牛头梗	 生活
苏格兰折耳猫	 生活
高加索犬	 生活
巴哥犬	 生活
锦鲤	 生活
松狮	 生活
折耳猫	 生活
犰狳	 生活
巴西龟	 生活
法国斗牛犬	 生活
罗威纳犬	 生活
羊驼	 生活
虎皮鹦鹉	 生活
大白熊犬	 生活
阿富汗猎犬	 生活
孔雀鱼	 生活
英国斗牛犬	 生活
异国短毛猫	 生活
西伯利亚雪橇犬	 生活
银狐犬	 生活
中国狸花猫	 生活
缅因猫	 生活
阿拉斯加雪橇犬	 生活
挪威森林猫	 生活
法老王猎犬	 生活
龟苓膏	 生活
炸酱面	 生活
螺蛳粉	 生活
灌肠	 生活
双皮奶	 生活
绿豆糕	 生活
重庆小面	 生活
煎饼果子	 生活
烤冷面	 生活
凉粉	 生活
凉皮	 生活
北京烤鸭	 生活
肠粉	 生活
冰粉	 生活
沙县小吃	 生活
肉夹馍	 生活
热干面	 生活
关东煮	 生活
臭豆腐	 生活
豆腐脑	 生活
糯米糍	 生活
胡辣汤	 生活
驴肉火烧	 生活
冒菜	 生活
煎饼	 生活
凉糕	 生活
油条	 生活
板栗	 生活
鸡蛋仔	 生活
醪糟	 生活
糍粑	 生活
米粉	 生活
藕粉	 生活
韭菜盒子	 生活
过桥米线	 生活
小笼包	 生活
叉烧	 生活
酸辣粉	 生活
春卷	 生活
南瓜饼	 生活
手抓羊肉	 生活
烧麦	 生活
锅盔	 生活
鸡蛋灌饼	 生活
羊肉泡馍	 生活
羊肉串	 生活
驴打滚	 生活
豆汁	 生活
刀削面	 生活
卤煮	 生活
微微一笑很倾城	 生活
平凡的世界	 生活
盗墓笔记	 生活
鬼吹灯	 生活
匆匆那年	 生活
白鹿原	 生活
温暖的弦	 生活
泡沫之夏	 生活
夏至未至	 生活
忽而今夏	 生活
查理九世	 生活
论语	 生活
道德经	 生活
何以笙箫默	 生活
白夜行	 生活
骆驼祥子	 生活
无人生还	 生活
明朝那些事儿	 生活
百年孤独	 生活
东方快车谋杀案	 生活
史记	 生活
洛丽塔	 生活
简爱	 生活
聊斋志异	 生活
围城	 生活
解忧杂货店	 生活
悲惨世界	 生活
悟空传	 生活
基督山伯爵	 生活
人间失格	 生活
挪威的森林	 生活
追风筝的人	 生活
源氏物语	 生活
嫌疑人x的献身	 生活
傅雷家书	 生活
摆渡人	 生活
假如给我三天光明	 生活
大清相国	 生活
鲁滨逊漂流记	 生活
悲伤逆流成河	 生活
心灵鸡汤	 生活
人性的弱点	 生活
老人与海	 生活
格列佛游记	 生活
月亮和六便士	 生活
清华大学	 生活
北京大学	 生活
中山大学	 生活
武汉大学	 生活
浙江大学	 生活
华东师范大学	 生活
华南理工大学	 生活
东南大学	 生活
厦门大学	 生活
复旦大学	 生活
南京大学	 生活
苏州大学	 生活
山东大学	 生活
中南大学	 生活
华中科技大学	 生活
四川大学	 生活
电子科技大学	 生活
同济大学	 生活
深圳大学	 生活
暨南大学	 生活
西南大学	 生活
上海交通大学	 生活
上海大学	 生活
南开大学	 生活
重庆大学	 生活
郑州大学	 生活
西南交通大学	 生活
天津大学	 生活
江南大学	 生活
中国人民大学	 生活
西安交通大学	 生活
北京理工大学	 生活
大连理工大学	 生活
北京师范大学	 生活
湖南大学	 生活
广州大学	 生活
吉林大学	 生活
中国海洋大学	 生活
北京交通大学	 生活
中南财经政法大学	 生活
武汉理工大学	 生活
杭州电子科技大学	 生活
中国传媒大学	 生活
西北工业大学	 生活
西南财经大学	 生活
华中师范大学	 生活
南京师范大学	 生活
河海大学	 生活
上海财经大学	 生活
东北大学	 生活
雅诗兰黛	 生活
海蓝之谜	 生活
兰蔻	 生活
迪奥	 生活
香奈儿	 生活
圣罗兰	 生活
dhc	 生活
sk-ii	 生活
阿玛尼	 生活
纪梵希	 生活
资生堂	 生活
科颜氏	 生活
巴黎欧莱雅	 生活
雪花秀	 生活
娇韵诗	 生活
花皙蔻	 生活
薇姿	 生活
悦诗风吟	 生活
倩碧	 生活
兰芝	 生活
自然堂	 生活
foreo	 生活
希思黎	 生活
资生堂安热沙	 生活
娇兰	 生活
mac	 生活
玉兰油	 生活
百雀羚	 生活
雅漾	 生活
玫琳凯	 生活
佰草集	 生活
汤姆福特	 生活
ray	 生活
肌肤之钥	 生活
屈臣氏	 生活
丝芙兰	 生活
珀莱雅	 生活
范思哲	 生活
fancl	 生活
欧珀莱	 生活
馥蕾诗	 生活
瑞倪维儿	 生活
韩束	 生活
jmsolution	 生活
高田贤三	 生活
理肤泉	 生活
祖马龙	 生活
whoo后	 生活
gucci	 生活
香奈儿	 生活
lv	 生活
ysl	 生活
卡地亚	 生活
coach	 生活
阿玛尼	 生活
劳力士	 生活
爱马仕	 生活
宝格丽	 生活
迪奥	 生活
欧米茄	 生活
浪琴	 生活
范思哲	 生活
prada	 生活
百达翡丽	 生活
派克	 生活
巴宝莉	 生活
巴黎世家	 生活
杜嘉班纳	 生活
菲拉格慕	 生活
万宝龙	 生活
tiffany	 生活
江诗丹顿	 生活
梵克雅宝	 生活
celine	 生活
积家	 生活
chloe	 生活
loewe	 生活
芬迪	 生活
豪爵	 生活
伯爵	 生活
hugo boss	 生活
宝玑	 生活
沛纳海	 生活
paul smith	 生活
miumiu	 生活
爱彼	 生活
marc jacobs	 生活
帝舵	 生活
百年灵	 生活
ralph lauren	 生活
宝珀	 生活
harry winston	 生活
chaumet	 生活
登喜路	 生活
腾讯公益	 生活
壹基金	 生活
天黑请闭眼	 游戏
赛尔号	 游戏
洛克王国	 游戏
火影忍者ol	 游戏
奥拉星	 游戏
星球大战	 游戏
奥奇传说	 游戏
山海	 游戏
王者天下	 游戏
斗罗大陆	 游戏
水浒传	 游戏
盗墓笔记	 游戏
帽子戏法	 游戏
摩尔庄园	 游戏
小花仙	 游戏
杀破狼	 游戏
加勒比海盗	 游戏
奥比岛	 游戏
全面战争	 游戏
三国杀online	 游戏
梦想三国	 游戏
天书奇谈	 游戏
塔防三国志	 游戏
神仙道	 游戏
创世纪	 游戏
攻城掠地	 游戏
一球成名	 游戏
绝代双骄	 游戏
轩辕剑	 游戏
炫舞时代	 游戏
九品芝麻官	 游戏
满江红	 游戏
小李飞刀	 游戏
弹弹堂	 游戏
秘密花园	 游戏
斗龙战士	 游戏
聊斋	 游戏
上帝也疯狂	 游戏
德州扑克	 游戏
武林外传	 游戏
兵马俑	 游戏
坦克大战	 游戏
英雄杀	 游戏
七雄争霸	 游戏
共和国之辉	 游戏
兵临城下	 游戏
战争之王	 游戏
梦幻西游	 游戏
英雄联盟	 游戏
dota2	 游戏
我的世界	 游戏
逆水寒	 游戏
天涯明月刀	 游戏
魔兽世界	 游戏
剑网3	 游戏
流放之路	 游戏
坦克世界	 游戏
穿越火线	 游戏
问道	 游戏
神武	 游戏
诛仙	 游戏
方舟生存进化	 游戏
逆战	 游戏
魔力宝贝	 游戏
守望先锋	 游戏
300英雄	 游戏
冒险岛	 游戏
地下城与勇士	 游戏
传奇	 游戏
剑灵	 游戏
qq飞车	 游戏
热血传奇	 游戏
战舰世界	 游戏
龙之谷	 游戏
传奇世界	 游戏
变形金刚	 游戏
天龙八部	 游戏
星际战甲	 游戏
激战2	 游戏
灵山奇缘	 游戏
跑跑卡丁车	 游戏
风暴英雄	 游戏
暗黑破坏神3	 游戏
冒险岛2	 游戏
枪神纪	 游戏
热血江湖	 游戏
魔域	 游戏
封印者	 游戏
九阴真经	 游戏
英魂之刃	 游戏
qq炫舞	 游戏
宠物小精灵	 游戏
游戏人生	 游戏
qq三国	 游戏
最终幻想14	 游戏
大话西游2	 游戏
少年三国志	 游戏
梦幻西游	 游戏
王者荣耀	 游戏
火影忍者	 游戏
荒野行动	 游戏
阴阳师	 游戏
炉石传说	 游戏
崩坏3	 游戏
神雕侠侣	 游戏
楚留香	 游戏
神武3	 游戏
不思议迷宫	 游戏
欢乐斗地主	 游戏
塔防三国志	 游戏
萌战	 游戏
终结者2审判日	 游戏
永远的7日之都	 游戏
我叫mt	 游戏
天龙八部手游	 游戏
刀塔传奇	 游戏
造梦西游	 游戏
天天酷跑	 游戏
魔卡幻想	 游戏
撸啊撸	 游戏
魔女之泉3	 游戏
节奏大师	 游戏
丛林法则	 游戏
非人学园	 游戏
剑侠世界2	 游戏
时空猎人	 游戏
佣兵天下	 游戏
最囧游戏2	 游戏
放开那三国	 游戏
大掌门	 游戏
三国如龙传	 游戏
如来神掌	 游戏
混沌与秩序	 游戏
天天飞车	 游戏
逐鹿中原	 游戏
天天爱消除	 游戏
长生诀	 游戏
魔法王座	 游戏
王者之剑	 游戏
蜀门手游	 游戏
恋舞ol	 游戏
部落战争	 游戏
植物大战僵尸	 游戏
使命召唤	 游戏
拳皇	 游戏
愤怒的小鸟	 游戏
射雕英雄传	 游戏
刺客信条起源	 游戏
使命召唤14	 游戏
神庙逃亡电脑版	 游戏
数独	 游戏
斗地主	 游戏
仁王	 游戏
幽灵行动	 游戏
会说话的汤姆猫2	 游戏
缺氧	 游戏
生化危机7	 游戏
大富翁	 游戏
欢乐斗地主	 游戏
合金弹头	 游戏
泡泡堂	 游戏
黄金矿工	 游戏
超级玛丽	 游戏
猎天使魔女	 游戏
密室逃脱	 游戏
蜘蛛纸牌	 游戏
宠物连连看	 游戏
暴力摩托	 游戏
魂斗罗	 游戏
大鱼吃小鱼	 游戏
逃生2	 游戏
恶灵附身2	 游戏
皇帝成长计划	 游戏
狂扁小朋友	 游戏
果蔬连连看	 游戏
极品台球3	 游戏
保卫萝卜	 游戏
俄罗斯方块	 游戏
变形金刚	 游戏
你画我猜	 游戏
坦克大战	 游戏
搞怪碰碰球在线玩	 游戏
五子棋	 游戏
打豆豆	 游戏
掘地求升	 游戏
街头霸王2	 游戏
合金装备5	 游戏
捕鱼达人	 游戏
找你妹	 游戏
葫芦娃	 游戏
三国战记	 游戏
泡泡龙	 游戏
银魂	 动漫
炮炮兵	 动漫
熊出没	 动漫
蜡笔小新	 动漫
海绵宝宝	 动漫
猫和老鼠	 动漫
芭比之梦想豪宅	 动漫
七龙珠	 动漫
爱探险的朵拉	 动漫
宠物小精灵	 动漫
大头儿子小头爸爸	 动漫
王牌御史	 动漫
十万个冷笑话	 动漫
黑猫警长	 动漫
出包王女	 动漫
贝瓦儿歌	 动漫
魔法禁书目录	 动漫
皮卡丘	 动漫
米奇妙妙屋	 动漫
香肠派对	 动漫
樱桃小丸子	 动漫
天线宝宝	 动漫
黄金神威	 动漫
守护甜心	 动漫
黑社会的超能力女儿	 动漫
成龙历险记	 动漫
爆肝工程师的异世界狂想曲	 动漫
三只松鼠	 动漫
元气少女缘结神	 动漫
熊出没之过年	 动漫
擅长捉弄的高木同学	 动漫
妄想学生会	 动漫
大耳朵图图	 动漫
斗龙战士	 动漫
天才麻将少女	 动漫
神兵小将	 动漫
倒霉熊	 动漫
r15	 动漫
南方公园	 动漫
罗小黑战记	 动漫
幻界王	 动漫
阿拉蕾	 动漫
咱们裸熊	 动漫
辛普森一家	 动漫
黑塔利亚	 动漫
奇奇颗颗历险记	 动漫
轻音少女	 动漫
只有神知道的世界	 动漫
中二病也要谈恋爱	 动漫
果宝特攻	 动漫
万古仙穹	 动漫
名侦探柯南	 动漫
蜡笔小新	 动漫
海绵宝宝	 动漫
猫和老鼠	 动漫
爱探险的朵拉	 动漫
大头儿子小头爸爸	 动漫
贝瓦儿歌	 动漫
米奇妙妙屋	 动漫
托马斯和他的朋友们	 动漫
天线宝宝	 动漫
大耳朵图图	 动漫
幽灵公主	 动漫
葫芦兄弟	 动漫
果宝特攻	 动漫
聪明的一休	 动漫
摩尔庄园	 动漫
猫和老鼠四川方言版	 动漫
小羊肖恩	 动漫
超能勇士	 动漫
巴布工程师	 动漫
飞哥与小佛	 动漫
围棋少年	 动漫
奇奇颗颗说恐龙	 动漫
东方神娃	 动漫
铁扇公主	 动漫
宝葫芦的秘密	 动漫
小鲤鱼历险记	 动漫
小猫钓鱼	 动漫
快乐星猫	 动漫
小鹿斑比	 动漫
小飞象	 动漫
十二生肖闯江湖	 动漫
小鸡不好惹	 动漫
猫和老鼠东北方言版	 动漫
逗逗迪迪爱探险	 动漫
航海王	 动漫
万古仙穹	 动漫
王者天下	 动漫
名侦探柯南	 动漫
斗罗大陆2绝世唐门	 动漫
死神	 动漫
妖精的尾巴	 动漫
全职猎人	 动漫
数码宝贝	 动漫
猪猪侠	 动漫
命运石之门	 动漫
犬夜叉	 动漫
万界仙踪	 动漫
七龙珠	 动漫
圣斗士星矢	 动漫
宠物小精灵	 动漫
王牌御史	 动漫
欧布奥特曼	 动漫
魔卡少女樱	 动漫
变形金刚	 动漫
夏目友人帐	 动漫
皮卡丘	 动漫
钢之炼金术师	 动漫
侠岚	 动漫
精灵梦叶罗丽	 动漫
乐高幻影忍者	 动漫
成龙历险记	 动漫
光之美少女	 动漫
银河英雄传说	 动漫
爆肝工程师的异世界狂想曲	 动漫
罪恶王冠	 动漫
三只松鼠	 动漫
神兽金刚	 动漫
女神异闻录	 动漫
赌博默示录	 动漫
金田一少年事件簿	 动漫
游戏王	 动漫
斗龙战士	 动漫
忍者神龟	 动漫
神兵小将	 动漫
倒霉熊	 动漫
百变小樱	 动漫
小飞侠	 动漫
幻影忍者	 动漫
幻界王	 动漫
星游记	 动漫
幽灵公主	 动漫
中华小当家	 动漫
浪客剑心	 动漫
洛洛历险记	 动漫
命运石之门	 动漫
黑执事	 动漫
鬼泣	 动漫
精灵梦叶罗丽	 动漫
四月是你的谎言	 动漫
烟花	 动漫
未闻花名	 动漫
世界第一初恋	 动漫
偷星九月天	 动漫
葫芦小金刚	 动漫
茜茜公主	 动漫
灰姑娘	 动漫
萤火之森	 动漫
罗密欧与朱丽叶	 动漫
东京暗鸦	 动漫
散华礼弥	 动漫
化物语	 动漫
冷然之天秤	 动漫
战场女武神	 动漫
纯情罗曼史	 动漫
魔法使的新娘	 动漫
只有神知道的世界	 动漫
白色相簿2	 动漫
公主恋人	 动漫
打上花火	 动漫
同班同学	 动漫
樱花庄的宠物女孩	 动漫
弑神者	 动漫
零之使魔	 动漫
吸血鬼骑士	 动漫
nana	 动漫
马丁的早晨	 动漫
魂狩	 动漫
名侦探柯南剧场版21	 动漫
无赖勇者的鬼畜美学	 动漫
我的朋友很少	 动漫
汤姆索亚历险记	 动漫
神笔马良	 动漫
无头骑士异闻录	 动漫
异世界魔王与召唤少女的奴隶魔术	 动漫
秋之回忆	 动漫
猫的报恩	 动漫
凉宫春日的忧郁	 动漫
织田信奈的野望	 动漫
甲贺忍法帖	 动漫
秒速5厘米	 动漫
星际牛仔	 动漫
棒球英豪	 动漫
魔物娘的同居日常	 动漫
犬夜叉完结篇	 动漫
炮炮兵	 动漫
万古仙穹	 动漫
斗罗大陆2绝世唐门	 动漫
尸兄	 动漫
魔道祖师	 动漫
熊出没	 动漫
一人之下	 动漫
狐妖小红娘	 动漫
龙珠超	 动漫
中国惊奇先生	 动漫
天行九歌	 动漫
莽荒纪	 动漫
齐木楠雄的灾难	 动漫
武庚纪	 动漫
妖怪名单	 动漫
巴啦啦小魔仙	 动漫
猪猪侠	 动漫
秦时明月之君临天下	 动漫
铠甲勇士	 动漫
万界仙踪	 动漫
大头儿子小头爸爸	 动漫
王牌御史	 动漫
十万个冷笑话	 动漫
我的逆天神器	 动漫
黑猫警长	 动漫
贝瓦儿歌	 动漫
香肠派对	 动漫
灵域	 动漫
侠岚	 动漫
精灵梦叶罗丽	 动漫
乐高幻影忍者	 动漫
灵契	 动漫
超智能足球	 动漫
成龙历险记	 动漫
银之守墓人	 动漫
三只松鼠	 动漫
神兽金刚	 动漫
我的天劫女友	 动漫
爱神巧克力	 动漫
熊出没之过年	 动漫
大耳朵图图	 动漫
斗龙战士	 动漫
偷星九月天	 动漫
神兵小将	 动漫
戒魔人	 动漫
葫芦小金刚	 动漫
罗小黑战记	 动漫
幻界王	 动漫
银魂	 动漫
航海王	 动漫
火影忍者	 动漫
阴阳师	 动漫
一拳超人	 动漫
王者天下	 动漫
我的英雄学院	 动漫
名侦探柯南	 动漫
东京食尸鬼	 动漫
进击的巨人	 动漫
龙珠超	 动漫
刀剑神域	 动漫
拳皇	 动漫
蜡笔小新	 动漫
死神	 动漫
灌篮高手	 动漫
妖精的尾巴	 动漫
起风了	 动漫
全职猎人	 动漫
名侦探柯南剧场版	 动漫
数码宝贝	 动漫
你的名字	 动漫
迪迦奥特曼	 动漫
命运石之门	 动漫
犬夜叉	 动漫
七龙珠	 动漫
约会大作战	 动漫
捷德奥特曼	 动漫
黑执事	 动漫
圣斗士星矢	 动漫
宠物小精灵	 动漫
欧布奥特曼	 动漫
全金属狂潮	 动漫
美少女战士	 动漫
魔卡少女樱	 动漫
网球王子	 动漫
夏目友人帐	 动漫
杀戮都市	 动漫
出包王女	 动漫
魔法禁书目录	 动漫
皮卡丘	 动漫
鬼泣	 动漫
从零开始的异世界生活	 动漫
剑风传奇	 动漫
樱桃小丸子	 动漫
钢之炼金术师	 动漫
未来日记	 动漫
为美好的世界献上祝福	 动漫
黄金神威	 动漫
守护甜心	 动漫
海绵宝宝	 动漫
猫和老鼠	 动漫
芭比之梦想豪宅	 动漫
爱探险的朵拉	 动漫
变形金刚	 动漫
蜘蛛侠	 动漫
米奇妙妙屋	 动漫
托马斯和他的朋友们	 动漫
天线宝宝	 动漫
忍者神龟	 动漫
小飞侠	 动漫
南方公园	 动漫
灰姑娘	 动漫
咱们裸熊	 动漫
辛普森一家	 动漫
白雪公主	 动漫
终极蜘蛛侠	 动漫
爱丽丝梦游仙境	 动漫
猫和老鼠四川方言版	 动漫
蓝精灵	 动漫
睡美人	 动漫
小羊肖恩	 动漫
巴巴爸爸	 动漫
帕丁顿熊	 动漫
木偶奇遇记	 动漫
飞哥与小佛	 动漫
猛兽侠	 动漫
丑小鸭	 动漫
龟兔赛跑	 动漫
加菲猫的幸福生活	 动漫
战神金刚	 动漫
大力水手	 动漫
降世神通	 动漫
小鹿斑比	 动漫
小飞象	 动漫
猫和老鼠东北方言版	 动漫
小熊维尼与跳跳虎	 动漫
变形金刚领袖之证	 动漫
麻辣女孩	 动漫
斗破苍穹	 动漫
银魂	 动漫
航海王	 动漫
火影忍者	 动漫
阴阳师	 动漫
炮炮兵	 动漫
西游记	 动漫
愤怒的小鸟	 动漫
星球大战	 动漫
万古仙穹	 动漫
一拳超人	 动漫
食戟之灵	 动漫
王者天下	 动漫
我的英雄学院	 动漫
名侦探柯南	 动漫
斗罗大陆2绝世唐门	 动漫
尸兄	 动漫
东京食尸鬼	 动漫
奥特曼	 动漫
汪汪队立大功	 动漫
七大罪	 动漫
魔道祖师	 动漫
熊出没	 动漫
一人之下	 动漫
进击的巨人	 动漫
狐妖小红娘	 动漫
龙珠超	 动漫
刀剑神域	 动漫
中国惊奇先生	 动漫
小马宝莉	 动漫
天行九歌	 动漫
拳皇	 动漫
剑灵	 动漫
熊出没之探险日记	 动漫
蜡笔小新	 动漫
死神	 动漫
莽荒纪	 动漫
妖神记	 动漫
海绵宝宝	 动漫
灌篮高手	 动漫
妖精的尾巴	 动漫
起风了	 动漫
猫和老鼠	 动漫
向日葵	 动漫
足球小将	 动漫
齐木楠雄的灾难	 动漫
全职猎人	 动漫
名侦探柯南剧场版	 动漫
武庚纪	 动漫
数码宝贝	 动漫
叶皓轩	人物
柳擎宇	人物
顾轻舟	人物
秦朗	人物
孙杨	人物
李昊	人物
秦一柱	人物
李琰	人物
丁涵	人物
柳溪	人物
莫璇	人物
孟浩	人物
祁天书	人物
施小诗	人物
沈青青	人物
楚云浩	人物
冷清溪	人物
陈帆	人物
马玉婷	人物
沈炼	人物
凌小兔	人物
林晚荣	人物
杨二龙	人物
陈潇	人物
墨青语	人物
叶旭	人物
唐晶	人物
林轻凡	人物
萧雅	人物
林菲菲	人物
阎宁	人物
楚林峰	人物
沈时寒	人物
陆文博	人物
霍依依	人物
谢潇潇	人物
张入云	人物
谢楠	人物
李缄	人物
林青瑶	人物
李中易	人物
欧阳彩	人物
唐昊	人物
董子健	人物
莫无忧	人物
张小雷	人物
况天佑	人物
韩小铮	人物
刘小溪	人物
李振鸿	人物
甘薇	人物
宋云萱	人物
周兆南	人物
马化腾	人物
陈天宁	人物
刘雯	人物
赵思雨	人物
陈羲	人物
冯宇	人物
董卿	人物
雷佳音	人物
慕容羽	人物
陈晖	人物
唐婉	人物
夏馨炎	人物
张扣扣	人物
端木蒙	人物
卫小北	人物
佟丽娅	人物
韩宝琦	人物
廖云枫	人物
凌玲	人物
苏青青	人物
徐佐言	人物
田甜甜	人物
丰玉珠	人物
顾兮兮	人物
马小铃	人物
夏晚晴	人物
牛大壮	人物
萧枫	人物
乔茜	人物
贾岩	人物
赫连宸枫	人物
阴雪歌	人物
樊振	人物
沈心怡	人物
刘琰	人物
徐媛	人物
曾宝珠	人物
李益岚	人物
宋子恒	人物
李国武	人物
徐嘉余	人物
黄渤	人物
兰绝尘	人物
嬴无翳	人物
宇文龙	人物
林小虎	人物
林丁丁	人物
龚宇	人物
庄不周	人物
姜宪	人物
章修严	人物
柳祖鑫	人物
唐红豆	人物
赵钢镚	人物
林君玄	人物
傅小鱼	人物
江慕桑	人物
刘君仪	人物
秦天戈	人物
左登峰	人物
柳月灵	人物
杨幂	人物
李彦宏	人物
刘雯雯	人物
顾清歌	人物
谢如琢	人物
沈晟	人物
刘佳宇	人物
赵仑	人物
赵斌	人物
诸葛沧澜	人物
李子孝	人物
马茸茸	人物
席靳南	人物
李木宇	人物
穆云霓	人物
杜宪	人物
唐嫣	人物
林正乐	人物
阮棉棉	人物
杨雪松	人物
苗毅	人物
周景瑜	人物
陈雯	人物
杜小笙	人物
霍景纬	人物
庄虎臣	人物
何永杰	人物
林烽	人物
俞青葵	人物
谭燕	人物
吕涛	人物
夏浔	人物
吴俊寰	人物
黎洛薇	人物
周远茹	人物
贾思邈	人物
沈云悠	人物
李天启	人物
梁小夏	人物
裴琦琦	人物
秦想浓	人物
庄小雅	人物
叶酌言	人物
颜以初	人物
冷浲澈	人物
楚莫寒	人物
谭骥炎	人物
胡亥	人物
苏子沫	人物
顾江洲	人物
冷御寒	人物
云菲菲	人物
苏初夏	人物
王韵臣	人物
靳怀瑾	人物
宋依诺	人物
马如龙	人物
许澄夜	人物
季苏菲	人物
叶清歌	人物
凌少云	人物
顾天泽	人物
李小琳	人物
丁小野	人物
李丹峰	人物
丁二苗	人物
凌天麒	人物
沈熙	人物
阮琨宁	人物
梅松庭	人物
汪东涵	人物
张家良	人物
莫某晶	人物
武倾尘	人物
李小厮	人物
魏雪盈	人物
端木玥	人物
阮念雪	人物
宋楚宜	人物
梁鹏飞	人物
顾南升	人物
沈名扬	人物
尧尧	人物
危秋洁	人物
肖笛	人物
摩尔诺	人物
陈小鲁	人物
杨美芹	人物
米莉娅	人物
杨无敌	人物
秦一恒	人物
沈佳楠	人物
杨雪峰	人物
陈梓军	人物
姜小凡	人物
焦明谦	人物
叶音竹	人物
伊皓泽	人物
秦牧森	人物
顾子衿	人物
颜雅茹	人物
顿了顿	人物
洛铁衣	人物
冷月默	人物
凤傲珺	人物
张若尘	人物
钟夜辰	人物
姜天亮	人物
苏以晴	人物
空桐樱	人物
杨初夏	人物
袁晶晶	人物
陈飞尘	人物
周冬雨	人物
江迪辉	人物
赵明瑞	人物
江疏影	人物
左元敏	人物
杜暖暖	人物
何无恨	人物
赫米娅	人物
林沉畹	人物
慕晓雪	人物
李悠扬	人物
李福根	人物
林楉纤	人物
秦北宴	人物
陈世锋	人物
易嘉帧	人物
江雨寒	人物
莫天寥	人物
杨宇军	人物
徐峥	人物
林欣怡	人物
欧阳云静	人物
曹旭	人物
栾小雪	人物
李小荷	人物
夏云初	人物
萧雨萱	人物
秋慕霜	人物
姜妍	人物
毛晓彤	人物
任正非	人物
齐天翔	人物
林天彪	人物
贺常棣	人物
苏星晖	人物
聂海晨	人物
赵出息	人物
沈存希	人物
铁柱哥	人物
郭奕	人物
叶初夏	人物
阴阳绣	人物
洛宇辰	人物
徐天晴	人物
魏祥	人物
钟子琦	人物
苏暖暖	人物
陆九霄	人物
雪明枫	人物
姚乐乐	人物
赵悲歌	人物
宋紫衣	人物
赵绅	人物
艾美娜	人物
顾筱北	人物
柳镜晓	人物
柳乾	人物
乔以沫	人物
林西凡	人物
杨峥	人物
冯睿	人物
林少秋	人物
凤轻歌	人物
易天辰	人物
介子推	人物
赵清染	人物
吴子健	人物
陶侃	人物
薛岳	人物
顾非瑾	人物
惠英红	人物
李承乾	人物
曲落幕	人物
黄蕊蕊	人物
王沥川	人物
龙天野	人物
林逸轩	人物
玄无奇	人物
贺昆仑	人物
叶雪峰	人物
荆高峰	人物
盛友坦	人物
杨安泽	人物
夏柠溪	人物
莫之遥	人物
阮天凌	人物
夏若瞳	人物
黄一飞	人物
唐雨欣	人物
贝佳倪	人物
沈煜	人物
马君武	人物
慕清涟	人物
杨衮	人物
穆恩丝	人物
曹可菲	人物
苏芷芯	人物
陈元凯	人物
沈若华	人物
宋之皓	人物
胡翔宇	人物
徐子捷	人物
轩辕殊珺	人物
陆少游	人物
沈梦瑶	人物
莫無忌	人物
沈曦	人物
古云枫	人物
沈衣雪	人物
谢清欢	人物
沈逸廷	人物
辛火姒	人物
孟苏何	人物
池承轩	人物
楚梦枕	人物
郑树亿	人物
罗天罡	人物
张星峰	人物
刘仙仙	人物
叶子熙	人物
刘洪滨	人物
楚昆阳	人物
莫一鸣	人物
丁承渊	人物
邱某某	人物
陈骁	人物
李明博	人物
林宏羽	人物
骆松源	人物
徐雅萍	人物
冷清秋	人物
叶宁潇	人物
李靳宇	人物
厉程杨	人物
傅明珠	人物
夏特克	人物
秦景阳	人物
韩雪雯	人物
厉昊南	人物
萧何吏	人物
芮玮	人物
伊芙	人物
贺连昊	人物
蒙光庆	人物
杨建军	人物
刘小混	人物
宋天逸	人物
塔图姆	人物
顾轻染	人物
翟羽	人物
刘诗诗	人物
百诺恩	人物
苏可歆	人物
江一执	人物
申正雨	人物
龙天啸	人物
俞敏洪	人物
陆亦辰	人物
柯少晨	人物
盛无忌	人物
晏暮青	人物
卫玠	人物
郭靖	人物
黎鸿	人物
陈小武	人物
乌寒雪	人物
姚懿悦	人物
林穆尘	人物
仙羽幻	人物
杨燚	人物
郁亮	人物
丁璇	人物
陈小希	人物
范桂霞	人物
陈浩楠	人物
钟玲秀	人物
丛佳佳	人物
王滺丽	人物
俞佩玉	人物
陈大伟	人物
苏小娅	人物
萧明昊	人物
王思聪	人物
楚清音	人物
鹿晗	人物
欧阳志远	人物
玉天恒	人物
欧超杯	人物
兰世立	人物
陈飞宇	人物
烟袋余	人物
雷大鹏	人物
南明玄	人物
江秋莲	人物
伍子墨	人物
秦子阳	人物
陆天臣	人物
许细温	人物
碧芙源	人物
纪迎夏	人物
郭虎禅	人物
王宗景	人物
纪惟言	人物
孟旭	人物
毛振华	人物
秋清怡	人物
彭蕾	人物
张林苍	人物
崔景钰	人物
楚双双	人物
李绪义	人物
楚兰兮	人物
马明哲	人物
沈涵秋	人物
吴海华	人物
贺三郎	人物
张继科	人物
秦俊熙	人物
陈二狗	人物
陈佳豪	人物
姜婷婷	人物
莫少离	人物
孟代南	人物
宁洛歌	人物
李易峰	人物
黄龙派	人物
马加爵	人物
于菲	人物
虎飞啸	人物
李未央	人物
林浩轩	人物
赵通达	人物
林诗雅	人物
古极峰	人物
唐舟舟	人物
萧朝虎	人物
虎千岁	人物
杨承志	人物
莫三孚	人物
吴友庆	人物
黄有龙	人物
郑吒	人物
戚幼晴	人物
杨银柱	人物
贺一鸣	人物
夏雨洋	人物
吴煜	人物
徐子枫	人物
冷御宸	人物
阮豪勇	人物
王俊凯	人物
李泽言	人物
叶浮屠	人物
鲁哈尼	人物
陈道笙	人物
楚寻锋	人物
李玮玲	人物
许立松	人物
彭于晏	人物
傅越泽	人物
池水墨	人物
焦俊艳	人物
阴不邪	人物
陆清宇	人物
宋辰飞	人物
杨凡	人物
霍青棠	人物
邓茂	人物
李泽钜	人物
李天凡	人物
张阳	人物
杜元潮	人物
江雪晴	人物
纪宁	人物
黄天奇	人物
轩辕天音	人物
刘誉伟	人物
顾安童	人物
雷振远	人物
宇文天昭	人物
盛明战	人物
曲淼	人物
乔小诺	人物
江雨辰	人物
郭广昌	人物
南宫宇寒	人物
梁炜菘	人物
沈天洛	人物
杨子琪	人物
闻人诗玉	人物
董二宝	人物
沃兰斯	人物
骆小远	人物
桂重阳	人物
铁苍熊	人物
魏晋晨	人物
蒋子虞	人物
许恒远	人物
乌木喉	人物
卓慕秋	人物
唐墨森	人物
秦先羽	人物
赵思诚	人物
杨逸风	人物
苏锦瑟	人物
江阿郎	人物
辛洛斯	人物
马林宇	人物
皇甫昊宸	人物
太史慈	人物
萧素滟	人物
姚林艺	人物
米小经	人物
龙小云	人物
斯派塞	人物
萧瑾	人物
巫魂界	人物
许家印	人物
周若辰	人物
夏七夕	人物
许秋阳	人物
段欣叶	人物
张少楠	人物
尹靖	人物
古小蘑	人物
蓝紫韵	人物
李琅枫	人物
温婧蓉	人物
卓逸寒	人物
胡馨竹	人物
艾莉妮	人物
陆泽川	人物
宋子宁	人物
赵青河	人物
蓝若涵	人物
沈青鸾	人物
张思毅	人物
阴魔宗	人物
苏锦帝	人物
萨提亚	人物
林皓青	人物
贺云龙	人物
李叫兽	人物
叶北辰	人物
叶琳薇	人物
沈珏	人物
摩顿森	人物
燕赵歌	人物
马莲娜	人物
朱承瑾	人物
吴永初	人物
林君飞	人物
厉御南	人物
叶怀阳	人物
唐百州	人物
樊小馀	人物
康二蛋	人物
鹿一凡	人物
罗明汉	人物
陈剑眉	人物
吴樾	人物
苏崇礼	人物
申屠家族	人物
吴达英	人物
卫信康	人物
仇民丰	人物
傅星河	人物
艾蜜莉	人物
沈可妍	人物
南宫煌	人物
莫良缘	人物
侯嬷嬷	人物
李冰洁	人物
楚天箫	人物
王笑嫣	人物
石宇奇	人物
叶湑	人物
楚西航	人物
乔晓恩	人物
叶知荫	人物
李泽逸	人物
杨云帆	人物
彭承志	人物
何浠源	人物
云初玖	人物
铁中棠	人物
南宫灵芸	人物
覃乐桑	人物
叶君璃	人物
苏莫邪	人物
徐璈	人物
楚莫轩	人物
顾天霖	人物
江雨菲	人物
吕剑雨	人物
张艺兴	人物
南宫硕	人物
周自恒	人物
苏晴雪	人物
徐天胤	人物
石子宸	人物
陈子锟	人物
李正阳	人物
傅克朗	人物
玄女宫	人物
梁诗雅	人物
独孤博	人物
陈世雄	人物
苏宏远	人物
郑殿荣	人物
陈志豪	人物
赵以澜	人物
夏可君	人物
王若芸	人物
吉HH	人物
墨天宇	人物
潘石屹	人物
欧阳明玄	人物
李宇浩	人物
王雨鑫	人物
郝添颂	人物
苏明娟	人物
林忘忧	人物
周凌川	人物
冯兴贵	人物
葛梦云	人物
林羽迪	人物
韩贝贝	人物
钟玉涵	人物
戚长征	人物
乔安荷	人物
苏晓晨	人物
蒋卓晨	人物
戚薇	人物
马静芬	人物
朴宝剑	人物
慕容凝宇	人物
库兹马	人物
王倩玉	人物
苏炳添	人物
云舒	人物
李翠萱	人物
李一飞	人物
杨丽颖	人物
陈青遥	人物
楼慕烟	人物
夏安暖	人物
慕春寅	人物
皋陶	人物
姚咏刚	人物
邱晓峰	人物
戴止忍	人物
宇城飞	人物
墨濯尘	人物
曾银剑	人物
章子梅	人物
孙宇晶	人物
秦菲菲	人物
拜西泽	人物
钟雁冰	人物
萧楚谦	人物
秦旭飞	人物
凤无霜	人物
陈化兰	人物
王芷瑶	人物
田菲菲	人物
姜笑依	人物
范我存	人物
陆元香	人物
叶央央	人物
刘仁峰	人物
唐念初	人物
夏颉	人物
赛琳娜	人物
赵山陵	人物
江树峰	人物
赵加诚	人物
姜晏维	人物
汪掌珠	人物
苏木君	人物
肖薇薇	人物
泰兰雅	人物
张易阳	人物
针织裙	人物
叶衡远	人物
谭文波	人物
沐清漪	人物
唐生智	人物
邱明辉	人物
郭沁	人物
裴珏	人物
凌若惜	人物
沈斯南	人物
柴宜哥	人物
檀啸	人物
叶珺钰	人物
罗玥	人物
王清颜	人物
袁紫菲	人物
黎姝墨	人物
王玉玲	人物
叶尘	人物
梅雪烟	人物
乔希宁	人物
罗某杰	人物
李凡愚	人物
墨云琛	人物
王器易	人物
姜正雨	人物
百里屠苏	人物
阮芷娘	人物
凤至柔	人物
朴槿惠	人物
贾玲	人物
潘小珍	人物
谌龙	人物
蓝斯辰	人物
赵心语	人物
蒋淑华	人物
谢景霄	人物
赵岁袅	人物
肖凝兒	人物
玉兔族	人物
傅园慧	人物
徐诗韵	人物
蔡志雄	人物
袁青玉	人物
曾联松	人物
冉冬夜	人物
庄明歌	人物
孔令华	人物
柳依依	人物
夕如云	人物
凌采薇	人物
章小涂	人物
陆石屹	人物
束活坚	人物
邱向阳	人物
齐凌川	人物
赵锦钰	人物
萧君夕	人物
龚美婷	人物
杜喆	人物
陈青牛	人物
林玉芳	人物
赵白石	人物
马大宽	人物
许文洋	人物
张钧甯	人物
莫小荷	人物
青瓦兰	人物
刘雨欣	人物
姜尚馀	人物
卓逸轩	人物
顾挽歌	人物
孟言茉	人物
陆北宸	人物
陆曼卿	人物
飞棱星	人物
谭景御	人物
云沫苏	人物
李明皓	人物
隋文静	人物
墨子涵	人物
李月兰	人物
苑碧棠	人物
莱修斯	人物
郑明析	人物
叶一哲	人物
孙宏斌	人物
岳依依	人物
莫子豪	人物
楚轻侯	人物
林兆晴	人物
纪峥	人物
宋茜	人物
陆雨汐	人物
林笑棠	人物
石涧仁	人物
闻人岩	人物
贾心贝	人物
林晚杰	人物
宫青羽	人物
秦泽榕	人物
沈一宾	人物
普天韵	人物
贾安坤	人物
齐上阵	人物
傅子宸	人物
马卡龙	人物
黄子韬	人物
宁文儒	人物
翟某欣	人物
霍福德	人物
凤君敏	人物
郝蕾	人物
尤文凤	人物
曾少鹏	人物
聂仙铃	人物
汤兰兰	人物
贺子俊	人物
古邪尘	人物
苏菡梦	人物
杜文宇	人物
龙麟释	人物
段泽涛	人物
张伯驹	人物
杨冬青	人物
赛波夫	人物
孙楠楠	人物
席祁玥	人物
百里胤南	人物
弥洛斯	人物
林志杰	人物
燕飞扬	人物
莫瑷瑷	人物
塞拉拉	人物
沈一帆	人物
顾卿晚	人物
麦吉丽	人物
秦昭阳	人物
冯提莫	人物
秦书凯	人物
刘亚庆	人物
杨高飞	人物
乔嘉纯	人物
柳三刀	人物
冯瑛	人物
楚天逸	人物
吴亦凡	人物
阮慕阳	人物
袁弘	人物
莫玲珑	人物
武小虎	人物
倪妮	人物
李若云	人物
萧驭南	人物
陶华碧	人物
梁斯彭	人物
蔡澜	人物
柳雨筠	人物
蒋飞	人物
王锦凌	人物
潘紫莹	人物
魏刚宁	人物
李元兴	人物
吴珺	人物
伊阿古	人物
纳兰冰	人物
韩佑熙	人物
唐晓瑜	人物
云倚萝	人物
许鞍华	人物
罗彩衣	人物
马思纯	人物
姬存希	人物
虞璇玑	人物
陆曼妮	人物
胡一亭	人物
林晓菲	人物
王端瀚	人物
李七夜	人物
顾天骏	人物
言初音	人物
杜蕾丝	人物
叶流云	人物
虞璟垚	人物
沈时怡	人物
李雨柔	人物
碧波庭	人物
叶平宇	人物
纳兰凤	人物
顾洛睿	人物
雪千寻	人物
刘璟	人物
欧伊辰	人物
苏氵木	人物
巫妖	人物
岳琦	人物
赵凌雪	人物
辜月舞	人物
殷蓁蓁	人物
谢思涵	人物
欧阳羽	人物
罗建刚	人物
姜哲雨	人物
柏峻言	人物
赵曼曼	人物
季若仙	人物
闫妮	人物
姜尚余	人物
顾若熙	人物
严鸿德	人物
刘忠林	人物
顾言溪	人物
慕容墨	人物
傅锦荣	人物
孔凝华	人物
凌郎君	人物
慕容夕颜	人物
卓冠堂	人物
柴碧云	人物
江智薰	人物
唐晓菲	人物
宋念轻	人物
张健豪	人物
锺子琦	人物
唐紫希	人物
龙墨臣	人物
张碧晨	人物
魏仁杰	人物
秦不空	人物
阴若梦	人物
张弥曼	人物
郭伯言	人物
塞壬	人物
刁磊	人物
霍鹏举	人物
桑萌萌	人物
陶笛	人物
姜耀祖	人物
乌逸凡	人物
陆峥	人物
顾夜歌	人物
钟小印	人物
登山杖	人物
刘筱怡	人物
楚雁卿	人物
甄嬛	人物
赵元亮	人物
林浮羽	人物
五岳派	人物
权天睿	人物
叶心姿	人物
谭笑笑	人物
罗齐尔	人物
范丞丞	人物
姬天赐	人物
俞曼珊	人物
宋二笙	人物
傅嘉树	人物
百里嘉琬	人物
王军辉	人物
景重铭	人物
傅剑玲	人物
战熠阳	人物
韩庚	人物
曹淑敏	人物
周子昀	人物
麻老九	人物
梁耀辉	人物
俞陌津	人物
宋雷义	人物
石恒聪	人物
李袖春	人物
石中玉	人物
卫君邪	人物
顾方华	人物
欧阳昭	人物
兰子卿	人物
沐冰雪	人物
夏梓晴	人物
厉昱钦	人物
李芸菲	人物
蒋璐霞	人物
希努尔	人物
哈莉玛	人物
李明霖	人物
侯柳海	人物
苍穹皇	人物
李青鸾	人物
福特森	人物
魏承泽	人物
孙向景	人物
尹子夜	人物
罗继军	人物
李盈莹	人物
林玥欢	人物
刘涵涵	人物
王炳忠	人物
冷寒轩	人物
何玖珊	人物
熊梦飞	人物
黄明端	人物
姚花影	人物
顾惜妍	人物
汪剑秋	人物
姬热拉	人物
田继伟	人物
辛德拉	人物
慕傲廷	人物
穆雪滢	人物
盛昭曦	人物
秦梦梦	人物
杨丽璐	人物
苏妙言	人物
乔瑟夫	人物
洛子初	人物
林芷韵	人物
张永焕	人物
池骋	人物
彭梓祺	人物
梁秋云	人物
聂远龙	人物
李相赫	人物
谢晓兰	人物
崔敏静	人物
苏樱雪	人物
宋倾城	人物
许纤柔	人物
严彩萱	人物
苏享茂	人物
王志涛	人物
穆勒鞋	人物
乔安暖	人物
雷迪克	人物
孙小玖	人物
祝玉琪	人物
徐黛珠	人物
竹心怡	人物
莫鳌馀	人物
甘志苍	人物
许格亦	人物
沈功百	人物
孟泽威	人物
姒文命	人物
袁谭	人物
廖瑾瑜	人物
陆正秦	人物
宁荣荣	人物
邱雁君	人物
莫云轩	人物
乌朵朵	人物
赵大柱	人物
苏妍汐	人物
林梦若	人物
叶沉鱼	人物
杜小猫	人物
韩倪霜	人物
郭炳辰	人物
李嬷嬷	人物
顾毓铮	人物
苏慕汐	人物
孙世杰	人物
孟祥宇	人物
萧沐谦	人物
霍少波	人物
张培刚	人物
顾逖泉	人物
莫智渊	人物
沈安乔	人物
寒初雪	人物
姬玄	人物
刘莹莹	人物
周鸿祎	人物
钟小渝	人物
严曼曼	人物
魏立华	人物
言仲洺	人物
苏自坚	人物
李婉扬	人物
刘晓宇	人物
凌天羽	人物
巴德鑫	人物
谷芝兰	人物
丁培培	人物
乔一峰	人物
林铭	人物
龙天麟	人物
崔永元	人物
范冰冰	人物
刘震云	人物
冯小刚	人物
金星	人物
徐帆	人物
刘强东	人物
强东	人物
奶茶妹妹	人物
张一鸣	人物
陆奇	人物
邓肯	人物
马化腾	人物
张晓龙	人物
大S	人物
小S	人物
周渝民	人物
汪小菲	人物
乔布斯	人物
扎克伯格	人物
马云	人物
迈克尔杰克逊	人物
宋慧乔	人物
宋仲基	人物
詹姆斯·卡梅隆	人物
关晓彤	人物
王健林	人物
夏雨	人物
章子怡	人物
汤唯	人物
徐静蕾	人物
章泽天	人物
李光洙	人物
雷军	人物
张一鸣	人物
黄宗泽	人物
潘斌龙	人物
小沈阳	人物
张柏芝	人物
奚梦瑶	人物
金英权	人物
渤哥	人物
红雷哥	人物
孙红雷	人物
黄渤	人物
黄磊	人物
鸡条	人物
罗志祥	人物
神算子	人物
王迅	人物
小绵羊	人物
小猪	人物
颜王	人物
张艺兴	人物
艺兴	人物
朱碧石	人物
猪哥	人物
